識	识	shí	to know/knowledge/Taiwan pr. [shì]
識	识	zhì	to record/to write a footnote
一般見識	一般见识	yī bān jiàn shi	to lower oneself to sb's level/to argue with sb less well-informed
下意識	下意识	xià yì shí	subconscious mind
不怕不識貨，只怕貨比貨	不怕不识货，只怕货比货	bù pà bù shí huò , zhǐ pà huò bǐ huò	lit. don't worry about not knowing goods, but about comparing them (proverb)/fig. goods' (or person's) true value can only be determined through comparison
不怕不識貨，就怕貨比貨	不怕不识货，就怕货比货	bù pà bù shí huò , jiù pà huò bǐ huò	lit. don't worry about not knowing goods, but about comparing them (proverb)/fig. goods' (or person's) true value can only be determined through comparison
不打不成相識	不打不成相识	bù dǎ bù chéng xiāng shí	don't fight, won't make friends (idiom); an exchange of blows may lead to friendship
不打不相識	不打不相识	bù dǎ bù xiāng shí	lit. don't fight, won't make friends (idiom); an exchange of blows may lead to friendship/no discord, no concord
不識一丁	不识一丁	bù shí yī dīng	total illiterate/unable to read the simplest characters
不識大體	不识大体	bù shí dà tǐ	to fail to see the larger issue (idiom)/to fail to grasp the big picture
不識好歹	不识好歹	bù shí hǎo dǎi	unable to tell good from bad (idiom)/undiscriminating
不識字	不识字	bù shí zì	illiterate
不識廬山真面目	不识庐山真面目	bù shì Lú shān zhēn miàn mù	lit. not to know the true face of Lushan Mountain/fig. can't see the forest for the trees
不識抬舉	不识抬举	bù shí tái jǔ	fail to appreciate sb's kindness/not know how to appreciate favors
不識時務	不识时务	bù shí shí wù	to show no understanding of the times (idiom); cannot adapt to current circumstances/not amenable to reason
不識時變	不识时变	bù shí shí biàn	to show no understanding of the times (idiom); cannot adapt to current circumstances/not amenable to reason
不識泰山	不识泰山	bù shí Tài Shān	can't recognize Mt Taishan (idiom); fig. not to recognize a famous person
不識高低	不识高低	bù shí gāo dī	can't recognize tall or short (idiom); doesn't know what's what
世界知識產權組織	世界知识产权组织	Shì jiè Zhī shí Chǎn quán Zǔ zhī	World Intellectual Property Organization
九二共識	九二共识	Jiǔ Èr Gòng shí	1992 Consensus, statement issued after 1992 talks between PRC and Taiwan representatives, asserting that there is only one China
似曾相識	似曾相识	sì céng xiāng shí	déjà vu (the experience of seeing exactly the same situation a second time)/seemingly familiar/apparently already acquainted
元語言學意識	元语言学意识	yuán yǔ yán xué yì shí	metalinguistic awareness
光學字符識別	光学字符识别	guāng xué zì fú shí bié	optical character recognition, OCR
公共知識分子	公共知识分子	gōng gòng zhī shi fèn zǐ	public intellectual (sometimes used derogatorily)
共識	共识	gòng shí	common understanding/consensus
冷知識	冷知识	lěng zhī shi	trivia
前意識	前意识	qián yì shí	preconscious/preconsciousness
卓識	卓识	zhuó shí	superior judgment/sagacity
博聞多識	博闻多识	bó wén duō shí	learned and erudite/knowledgeable and experienced
博聞強識	博闻强识	bó wén qiáng shí	erudite/widely read and knowledgeable
博識	博识	bó shí	knowledgeable/erudite/erudition/proficient
博識多通	博识多通	bó shí duō tōng	knowledgeable and perspicacious (idiom)
博識洽聞	博识洽闻	bó shí qià wén	knowledgeable/erudite (idiom)
反知識	反知识	fǎn zhī shi	anti-intellectual
句法意識	句法意识	jù fǎ yì shí	syntactic awareness
名重識暗	名重识暗	míng zhòng shí àn	of great reputation but shallow in knowledge (idiom)
唯識宗	唯识宗	Wéi shí zōng	Yogācāra school of Buddhism/Consciousness-only school of Buddhism
學識	学识	xué shí	erudition/scholarly knowledge
射頻識別	射频识别	shè pín shí bié	radio-frequency identification (RFID)
常識	常识	cháng shí	common sense/general knowledge/CL:門|门[mén]
思想意識	思想意识	sī xiǎng yì shí	consciousness
意識	意识	yì shí	consciousness/awareness/to be aware/to realize
意識型態	意识型态	yì shí xíng tài	variant of 意識形態|意识形态[yì shí xíng tài]
意識形態	意识形态	yì shí xíng tài	ideology
意識流	意识流	yì shí liú	stream of consciousness (in literature)
感性認識	感性认识	gǎn xìng rèn shi	perceptual awareness
手寫識別	手写识别	shǒu xiě shí bié	handwriting recognition
才識	才识	cái shí	ability and insight
才識過人	才识过人	cái shí guò rén	an outstanding talent (idiom)/surpassing insight and acumen
技術知識	技术知识	jì shù zhī shi	technical knowledge
數據鏈路連接標識	数据链路连接标识	shù jù liàn lù lián jiē biāo zhì	data link connection identifier (DLCI)
有意識	有意识	yǒu yì shí	conscious
有眼不識泰山	有眼不识泰山	yǒu yǎn bù shí Tài Shān	lit. to have eyes but fail to recognize Mt Tai (idiom)/fig. to fail to recognize sb important or sb's great talent/to be blind to the fact
有識之士	有识之士	yǒu shí zhī shì	a person with knowledge and experience (idiom)
構詞法意識	构词法意识	gòu cí fǎ yì shí	morphological awareness
標識	标识	biāo zhì	variant of 標誌|标志[biāo zhì]
淵識	渊识	yuān shí	erudite and sophisticated
潛意識	潜意识	qián yì shí	unconscious mind/subconscious mind/subconsciousness
無意識	无意识	wú yì shí	unconscious/involuntary
熟識	熟识	shú shi	to be well acquainted with/to know well
狗咬呂洞賓，不識好人心	狗咬吕洞宾，不识好人心	gǒu yǎo Lǚ Dòng bīn , bù shí hǎo rén xīn	a dog biting Lü Dongbin (idiom)/to ill reward a person's kindness
理性知識	理性知识	lǐ xìng zhī shi	rational knowledge
理性認識	理性认识	lǐ xìng rèn shi	cognition/rational knowledge
略識之無	略识之无	lüè shí zhī wú	semiliterate/only knows words of one syllable/lit. to know only 之[zhī] and 無|无[wú]
目不識丁	目不识丁	mù bù shí dīng	lit. the eye cannot recognize the letter T (idiom); totally illiterate
相識	相识	xiāng shí	to get to know each other/acquaintance
知慳識儉	知悭识俭	zhī qiān shí jiǎn	to know how to be economical (idiom)
知識	知识	zhī shi	knowledge/CL:門|门[mén]/intellectual
知識分子	知识分子	zhī shi fèn zǐ	intellectual/intelligentsia/learned person
知識寶庫	知识宝库	zhī shi bǎo kù	treasure house of knowledge
知識工程師	知识工程师	zhī shi gōng chéng shī	knowledge worker
知識庫	知识库	zhī shi kù	knowledge base
知識產權	知识产权	zhī shi chǎn quán	intellectual property rights (law)
知識界	知识界	zhī shi jiè	intellectual circles/intelligentsia
知識論	知识论	zhī shí lùn	epistemology
知識越多越反動	知识越多越反动	zhī shi yuè duō yuè fǎn dòng	the more knowledgeable, the more reactionary (absurd anti-intellectual slogan attributed after the event to the Gang of Four 四人幫|四人帮)
礙口識羞	碍口识羞	ài kǒu shí xiū	tongue-tied for fear of embarrassment (idiom)
科學知識	科学知识	kē xué zhī shi	scientific knowledge
程不識	程不识	Chéng Bù shí	Cheng Bushi, Han dynasty general
素不相識	素不相识	sù bù xiāng shí	to be total strangers (idiom)
結識	结识	jié shí	to get to know sb/to meet sb for the first time
老馬識途	老马识途	lǎo mǎ shí tú	an old horse knows the way (idiom); an experienced worker knows what to do/an old hand knows the ropes
膽識	胆识	dǎn shí	courage and insight
自我意識	自我意识	zì wǒ yì shí	self-awareness
舊識	旧识	jiù shí	former acquaintance/old friend
見多識廣	见多识广	jiàn duō shí guǎng	experienced and knowledgeable (idiom)
見識	见识	jiàn shi	to gain first-hand knowledge of sth/to experience for oneself/knowledge/experience/insight
見識淺	见识浅	jiàn shi qiǎn	short-sighted
認識	认识	rèn shi	to know/to recognize/to be familiar with/to get acquainted with sb/knowledge/understanding/awareness/cognition
認識不能	认识不能	rèn shi bù néng	agnosia
認識論	认识论	rèn shi lùn	epistemology (in philosophy, the theory of how we know things)
語音意識	语音意识	yǔ yīn yì shí	phonetic awareness
語音識別	语音识别	yǔ yīn shí bié	speech recognition
一丁不識	一丁不识	yī dīng bù shí	illiterate/ignorant
一字不識	一字不识	yī zì bù shí	totally illiterate
識別	识别	shí bié	to distinguish/to discern
識別碼	识别码	shí bié mǎ	identifier
識別號	识别号	shí bié hào	identifier
識力	识力	shí lì	discernment/the ability to judge well
識多才廣	识多才广	shí duō cái guǎng	knowledgeable and versatile
識字	识字	shí zì	to learn to read
識字率	识字率	shí zì lǜ	literacy rate
識度	识度	shí dù	knowledge and experience
識得	识得	shí de	to know
識微見幾	识微见几	shí wēi jiàn jǐ	lit. see a tiny bit and understand everything (idiom)
識才	识才	shí cái	to recognize talent
識才尊賢	识才尊贤	shí cái zūn xián	to recognize talent and have great respect for it
識數	识数	shí shù	to know how to count and do sums/numerate/numeracy
識文斷字	识文断字	shí wén duàn zì	literate/a cultured person
識時務	识时务	shí shí wù	to have a clear view of things/to adapt to circumstances
識時務者為俊傑	识时务者为俊杰	shí shí wù zhě wèi jùn jié	Only an outstanding talent can recognize current trends (idiom). A wise man submits to circumstances.
識時通變	识时通变	shí shí tōng biàn	understanding and adaptable
識時達務	识时达务	shí shí dá wù	understanding/to know what's up
識相	识相	shí xiàng	sensitive/tactful
識破	识破	shí pò	to penetrate/to see through
識破機關	识破机关	shí pò jī guān	to see through a trick
識羞	识羞	shí xiū	to know shame/to feel shame (often with a negative, shameless)
識荊	识荆	shí jīng	It is a great honor to meet you.
識荊恨晚	识荆恨晚	shí jīng hèn wǎn	It is a great honor to meet you and I regret it is not sooner
識見	识见	shí jiàn	knowledge and experience
識貨	识货	shí huò	to know what's what
識趣	识趣	shí qù	tactful/discreet
識途老馬	识途老马	shí tú lǎo mǎ	lit. an old horse knows the way home (idiom); fig. in difficulty, trust an experience colleague
賞識	赏识	shǎng shí	to appreciate/to recognize the worth of sth/appreciation
超前意識	超前意识	chāo qián yì shí	foresight
身份識別卡	身份识别卡	shēn fèn shí bié kǎ	identification card/ID card
辨識	辨识	biàn shí	identification/to identify/to recognize
通識	通识	tōng shí	general knowledge/overall knowledge/common knowledge/widely known/erudition
通識培訓	通识培训	tōng shí péi xùn	general culture
通識教育	通识教育	tōng shí jiào yù	general education
通識課程	通识课程	tōng shí kè chéng	general course/general education course/core course/general curriculum/general education curriculum/core curriculum
道德認識	道德认识	dào dé rèn shi	moral cognition/ethical awareness
遠見卓識	远见卓识	yuǎn jiàn zhuó shí	visionary and sagacious (idiom)
遠識	远识	yuǎn shí	foresight
鑑識	鉴识	jiàn shí	to identify/to detect
長知識	长知识	zhǎng zhī shi	to acquire knowledge
長見識	长见识	zhǎng jiàn shi	to gain knowledge and experience
預備知識	预备知识	yù bèi zhī shi	background knowledge/prerequisite
