迎	迎	yíng	to welcome/to meet/to face/to forge ahead (esp. in the face of difficulties)
出迎	出迎	chū yíng	to greet/to go out to meet
受歡迎	受欢迎	shòu huān yíng	popular/well-received
失迎	失迎	shī yíng	failure to meet/(humble language) I'm sorry not to have come to meet you personally
夾道歡迎	夹道欢迎	jiā dào huān yíng	to line the streets in welcome
奉迎	奉迎	fèng yíng	(honorific) to greet/to fawn
布防迎戰	布防迎战	bù fáng yíng zhàn	to prepare to meet the enemy head-on
愛彼迎	爱彼迎	Ài bǐ yíng	Airbnb
曲意逢迎	曲意逢迎	qū yì féng yíng	to bow down to everything sb says or does/to act submissively in order to ingratiate oneself
有失遠迎	有失远迎	yǒu shī yuǎn yíng	(polite) excuse me for not going out to meet you
歡迎	欢迎	huān yíng	to welcome/welcome
歡迎光臨	欢迎光临	huān yíng guāng lín	welcome
笑臉相迎	笑脸相迎	xiào liǎn xiāng yíng	to welcome sb with a smiling face (idiom)
不受歡迎	不受欢迎	bù shòu huān yíng	unwelcome
迎來送往	迎来送往	yíng lái sòng wǎng	lit. to meet those arriving, to send of those departing (idiom); busy entertaining guests/all time taken over with social niceties
迎刃而解	迎刃而解	yíng rèn ér jiě	lit. (bamboo) splits when it meets the knife's edge (idiom)/fig. easily solved
迎合	迎合	yíng hé	to cater to/to pander to
迎娶	迎娶	yíng qǔ	(of a groom) to escort the bride to the wedding ceremony/fig. to take as one's wife/to marry
迎客松	迎客松	Yíng kè Sōng	Greeting Pine, symbol of Huangshan 黃山|黄山[Huáng shān]
迎戰	迎战	yíng zhàn	to meet the enemy head-on
迎接	迎接	yíng jiē	to meet/to welcome/to greet
迎接挑戰	迎接挑战	yíng jiē tiǎo zhàn	to meet a challenge
迎擊	迎击	yíng jī	to face an attack/to repulse the enemy
迎新	迎新	yíng xīn	to see in the New Year/to welcome new guests/by extension, to receive new students
迎春花	迎春花	yíng chūn huā	winter jasmine (Jasminum nudiflorum)
迎江	迎江	Yíng jiāng	Yingjiang district of Anqing city 安慶市|安庆市[Ān qìng shì], Anhui
迎江區	迎江区	Yíng jiāng qū	Yingjiang district of Anqing city 安慶市|安庆市[Ān qìng shì], Anhui
迎澤	迎泽	Yíng zé	Yingze district of Taiyuan city 太原市[Tài yuán shì], Shanxi
迎澤區	迎泽区	Yíng zé qū	Yingze district of Taiyuan city 太原市[Tài yuán shì], Shanxi
迎火	迎火	yíng huǒ	backfire (firefighting)
迎神賽會	迎神赛会	yíng shén sài huì	folk festival, esp. involving shrine or image of God
迎親	迎亲	yíng qīn	(of the groom's family) to send a bridal sedan chair 花轎|花轿 to fetch the bride/to send a party to escort the bride to the groom's house
迎賓	迎宾	yíng bīn	to welcome a guest/to entertain a customer (of prostitute)
迎面	迎面	yíng miàn	directly/head-on (collision)/in one's face (of wind)
迎面而來	迎面而来	yíng miàn ér lái	directly/head-on (collision)/in one's face (of wind)
迎頭	迎头	yíng tóu	to meet head-on/face-to-face/directly
迎頭兒	迎头儿	yíng tóu r5	erhua variant of 迎頭|迎头[yíng tóu]
迎頭打擊	迎头打击	yíng tóu dǎ jī	to hit head on
迎頭痛擊	迎头痛击	yíng tóu tòng jī	to deliver a frontal assault/to meet head-on (idiom)
迎頭趕上	迎头赶上	yíng tóu gǎn shàng	to try hard to catch up
迎風	迎风	yíng fēng	in the wind/facing the wind/downwind
迎風招展	迎风招展	yíng fēng zhāo zhǎn	to flutter in the wind (idiom)
迎風飄舞	迎风飘舞	yíng fēng piāo wǔ	to whirl about in the wind
送往迎來	送往迎来	sòng wǎng yíng lái	see 迎來送往|迎来送往[yíng lái sòng wǎng]
送舊迎新	送旧迎新	sòng jiù yíng xīn	usher out the old, greet the new/esp. to see in the New Year
逢迎	逢迎	féng yíng	to fawn on/to ingratiate oneself/(literary) to meet face to face
