珍	珍	zhēn	precious thing/treasure/culinary delicacy/rare/valuable/to value highly
珎	珍	zhēn	variant of 珍[zhēn]
善自珍攝	善自珍摄	shàn zì zhēn shè	take good care of yourself! (idiom)
奇珍	奇珍	qí zhēn	a rare treasure/sth priceless and unique
奇珍異寶	奇珍异宝	qí zhēn yì bǎo	rare treasure (idiom)
如數家珍	如数家珍	rú shǔ jiā zhēn	lit. as if enumerating one's family valuables (idiom)/fig. to be very familiar with a matter
山珍海味	山珍海味	shān zhēn hǎi wèi	exotic delicacies/luxury foodstuff from distant locations
山珍海錯	山珍海错	shān zhēn hǎi cuò	rarities from the mountain and the sea (idiom); fig. a sumptuous spread of food delicacies
彌足珍貴	弥足珍贵	mí zú zhēn guì	extremely precious/valuable
敝帚自珍	敝帚自珍	bì zhǒu zì zhēn	to value the broom as one's own (idiom); to attach value to sth because it is one's own/a sentimental attachment
李時珍	李时珍	Lǐ Shí zhēn	Li Shizhen (1518-1593), Ming botanist and pharmacologist, author of Compendium of Medical Herbs 本草綱目|本草纲目[Běn cǎo Gāng mù]
李汝珍	李汝珍	Lǐ Rǔ zhēn	Li Ruzhen (c. 1763-c. 1830), Qing novelist and phonologist, author of fantasy novel Jinghua Yuan 鏡花緣|镜花缘 or Flowers in the Mirror
永珍	永珍	Yǒng zhēn	Vientiane, capital of Laos (Tw)
無價珍珠	无价珍珠	Wú jià Zhēn zhū	Pearl of Great Price (Mormonism)
煉珍	炼珍	liàn zhēn	a delicacy (food)
倪桂珍	倪桂珍	Ní Guì zhēn	Ni Guizhen or Ni Kwei-Tseng (1869 - 1931), mother of Song Ailing 宋藹齡|宋蔼龄[Sòng Ǎi líng], Song Qingling 宋慶齡|宋庆龄[Sòng Qìng líng] and Song Meiling 宋美齡|宋美龄[Sòng Měi líng]
珍·奧斯汀	珍·奥斯汀	Zhēn · Ào sī tīng	Jane Austen (1775-1817), English novelist/also written 簡·奧斯汀|简·奥斯汀[Jiǎn · Ào sī tīng]
珍品	珍品	zhēn pǐn	valuable object/curio
珍多冰	珍多冰	zhēn duō bīng	cendol, Southeast Asian iced sweet dessert
珍奇	珍奇	zhēn qí	rare/strange
珍奶	珍奶	zhēn nǎi	abbr. for pearl milk tea 珍珠奶茶
珍寶	珍宝	zhēn bǎo	a treasure
珍惜	珍惜	zhēn xī	to treasure/to value/to cherish
珍愛	珍爱	zhēn ài	to cherish
珍珠	珍珠	zhēn zhū	pearl/CL:顆|颗[kē]
珍珠奶茶	珍珠奶茶	zhēn zhū nǎi chá	pearl milk tea/tapioca milk tea/bubble milk tea
珍珠小番茄	珍珠小番茄	zhēn zhū xiǎo fān qié	see 聖女果|圣女果[shèng nǚ guǒ]
珍珠岩	珍珠岩	zhēn zhū yán	perlite
珍珠母	珍珠母	zhēn zhū mǔ	mother-of-pearl (used in ornamentation and in TCM)
珍珠港	珍珠港	Zhēn zhū Gǎng	Pearl Harbor (Hawaii)
珍珠翡翠白玉湯	珍珠翡翠白玉汤	zhēn zhū fěi cuì bái yù tāng	cabbage, rice and tofu soup
珍異	珍异	zhēn yì	rare/precious and odd
珍禽奇獸	珍禽奇兽	zhēn qín qí shòu	rare animals and birds
珍稀	珍稀	zhēn xī	rare/precious and uncommon
珍羞	珍羞	zhēn xiū	variant of 珍饈|珍馐, delicacy/dainties/rare foodstuff
珍聞	珍闻	zhēn wén	oddity/news tidbits/strange and interesting item
珍藏	珍藏	zhēn cáng	collection/to collect (valuables)
珍視	珍视	zhēn shì	to place great importance on/to treasure
珍貴	珍贵	zhēn guì	precious
珍重	珍重	zhēn zhòng	precious/extremely valuable/(honorific) Please take good care of yourself!
珍饈	珍馐	zhēn xiū	delicacy/dainties/rare foodstuff
珍饈美味	珍馐美味	zhēn xiū měi wèi	delicacy and fine taste (idiom); a wonderful treat
珍饈美饌	珍馐美馔	zhēn xiū měi zhuàn	delicacy and fine taste (idiom); a wonderful treat
八珍湯	八珍汤	bā zhēn tāng	eight-treasure decoction, tonic formula used in Chinese medicine
維珍	维珍	wéi zhēn	Virgin (company)
袖珍	袖珍	xiù zhēn	pocket-sized/pocket (book etc)
袖珍人	袖珍人	xiù zhēn rén	little person/midget/dwarf
袖珍本	袖珍本	xiù zhēn běn	pocket book/paperback
袖珍辭典	袖珍辞典	xiù zhēn cí diǎn	pocket dictionary
袖珍音響	袖珍音响	xiù zhēn yīn xiǎng	pocket stereo/walkman
賀子珍	贺子珍	Hè Zǐ zhēn	He Zizhen (1910-1984), Mao Zedong's third wife
賽珍珠	赛珍珠	Sài Zhēn zhū	Pearl S. Buck (1892-1973), American writer known for her novels on Asian cultures, Pulitzer Prize and Nobel Prize laureate
雞珍	鸡珍	jī zhēn	chicken gizzard (cuisine)
馬氏珍珠貝	马氏珍珠贝	mǎ shì zhēn zhū bèi	pearl oyster (genus Pinctada)
龔自珍	龚自珍	Gōng Zì zhēn	Gong Zizhen (1792-1841), Chinese man of letters, calligrapher and poet
