鋻	鉴	jiàn	variant of 鑑|鉴[jiàn]
鍳	鉴	jiàn	old variant of 鑒|鉴[jiàn]
鑑	鉴	jiàn	example/mirror/to view/reflection/to reflect/to inspect/to warn/(ancient bronze mirror)
鑒	鉴	jiàn	variant of 鑑|鉴[jiàn]
前車之鑒	前车之鉴	qián chē zhī jiàn	to learn a lesson from the mistakes of one's predecessor (idiom)
印鑒	印鉴	yìn jiàn	seal impression/stamp/mark from a seal serving as signature
品鑒	品鉴	pǐn jiàn	to judge/to examine/to evaluate
國家文物鑒定委員會	国家文物鉴定委员会	Guó jiā Wén wù Jiàn dìng Wěi yuán huì	National Commission for the Identification of Cultural Heritage
圖鑒	图鉴	tú jiàn	illustrated handbook
年鑑	年鉴	nián jiàn	annual report/yearbook/almanac
後車之鑒	后车之鉴	hòu chē zhī jiàn	lit. warning to the following cart (idiom); don't follow the track of an overturned cart/fig. draw lesson from the failure of one's predecessor/learn from past mistake/once bitten twice shy
德法年鑒	德法年鉴	Dé Fǎ Nián jiàn	Deutsch-Französische Jahrbücher (published once in 1844 by Karl Marx and bourgeois radical Arnold Ruge)
有鑒於此	有鉴于此	yǒu jiàn yú cǐ	in view of this/to this end
油光可鑒	油光可鉴	yóu guāng kě jiàn	lit. oily and shiny to the point of reflecting (idiom)/lustrous
洞鑒	洞鉴	dòng jiàn	to examine deeply/to inspect closely
親子鑒定	亲子鉴定	qīn zǐ jiàn dìng	paternity or maternity test
評鑒	评鉴	píng jiàn	evaluation/assessment
資治通鑒	资治通鉴	Zī zhì Tōng jiàn	A Mirror for the Wise Ruler (or Comprehensive Mirror for Aid in Government), a vast chronological general history, written by 司馬光|司马光[Sī mǎ Guāng] Sima Guang (1019-1089) and collaborators during the Northern Song in 1084, covering the period 403 BC-959 AD, 294 scrolls
賞鑒	赏鉴	shǎng jiàn	to appreciate (a work of art)
DNA鑒定	DNA鉴定	D N A jiàn dìng	DNA test/DNA testing
以史為鑒	以史为鉴	yǐ shǐ wéi jiàn	to learn from history (idiom)
借鑒	借鉴	jiè jiàn	to draw on (others' experience)/to learn from (how others do things)/lesson to be learned (by observing others)
鑑價	鉴价	jiàn jià	to appraise/appraisal/valuation
鑑別	鉴别	jiàn bié	to differentiate/to distinguish
鑑定	鉴定	jiàn dìng	to appraise/to identify/to evaluate
鑑證	鉴证	jiàn zhèng	appraisal/verification/authentication/forensic investigation
鑑識	鉴识	jiàn shí	to identify/to detect
鑑賞	鉴赏	jiàn shǎng	to appreciate (as a connoisseur)
鑑黃	鉴黄	jiàn huáng	to inspect videos and other media for pornographic content
鑑黃師	鉴黄师	jiàn huáng shī	content moderator specializing in pornographic material (both online and offline)
前車之覆，後車之鑒	前车之覆，后车之鉴	qián chē zhī fù , hòu chē zhī jiàn	lit. the cart in front overturns, a warning to the following cart (idiom); fig. draw lesson from the failure of one's predecessor/learn from past mistake/once bitten twice shy
鑒定委員會	鉴定委员会	jiàn dìng wěi yuán huì	evaluation committee/review board
鑒往知來	鉴往知来	jiàn wǎng zhī lái	to observe the past to foresee the future (idiom, taken loosely from Book of Songs); studying ancient wisdom gives insight into what is to come
鑒戒	鉴戒	jiàn jiè	lesson from events of the past/warning
鑒於	鉴于	jiàn yú	in view of/seeing that/considering/whereas
鑒真	鉴真	Jiàn zhēn	Jianzhen or Ganjin (688-763), Tang dynastic Buddhist monk, who crossed to Japan after several unsuccessful attempts, influential in Japanese Buddhism
鑒真和尚	鉴真和尚	Jiàn zhēn hé shang	Jianzhen or Ganjin (688-763), Tang Buddhist monk, who crossed to Japan after several unsuccessful attempts, influential in Japanese Buddhism
鑒賞家	鉴赏家	jiàn shǎng jiā	connoisseur/appreciative person/fan
龍龕手鑑	龙龛手鉴	Lóng kān Shǒu jiàn	Longkan Shoujian, Chinese character dictionary from 997 AD containing 26,430 entries, with radicals placed into 240 rhyme groups and arranged according to the four tones, and the rest of the characters similarly arranged under each radical
