限	限	xiàn	limit/bound/to set a limit (on)
不局限	不局限	bù jú xiàn	not confined
中國石油化工股份有限公司	中国石油化工股份有限公司	Zhōng guó Shí yóu Huà gōng Gǔ fèn Yǒu xiàn Gōng sī	China Petroleum and Chemical Corporation, Sinopec/abbr. to 中石化[Zhōng shí huà]
中航技進出口有限責任公司	中航技进出口有限责任公司	Zhōng háng jì Jìn chū kǒu Yǒu xiàn Zé rèn Gōng sī	China National Aero-Technology Import & Export Corporation (CATIC)
中遠太平洋有限公司	中远太平洋有限公司	zhōng yuǎn Tài píng yáng yǒu xiàn gōng sī	COSCO Pacific Limited, major freight company
侵限	侵限	qīn xiàn	intrusion/perimeter breach/(esp.) (of a person or a foreign object) to breach the perimeter surrounding railway tracks
侷限	局限	jú xiàn	variant of 局限[jú xiàn]
保利科技有限公司	保利科技有限公司	Bǎo lì Kē jì Yǒu xiàn Gōng sī	Poly Technologies (defense manufacturing company)
北京汽車製造廠有限公司	北京汽车制造厂有限公司	Běi jīng Qì chē Zhì zào chǎng Yǒu xiàn Gōng sī	Beijing Automobile Works (BAW)
半無限	半无限	bàn wú xiàn	semi-infinite
只限於	只限于	zhǐ xiàn yú	to be limited to
圉限	圉限	yǔ xiàn	boundary/limit
壽限	寿限	shòu xiàn	lifetime/length of life
大限	大限	dà xiàn	the limit/maximum/one's allocated lifespan
大限到來	大限到来	dà xiàn dào lái	to die/one's allocated lifespan is accomplished
大限臨頭	大限临头	dà xiàn lín tóu	facing the end (idiom); at the end of one's life/with one foot in the grave
寬限	宽限	kuān xiàn	to extend (a deadline etc)
寬限期	宽限期	kuān xiàn qī	grace period/period of grace
局限	局限	jú xiàn	to limit/to confine/to restrict sth within set boundaries
局限性	局限性	jú xiàn xìng	limitations/(medicine) localized
局限於	局限于	jú xiàn yú	to be limited to
崖限	崖限	yá xiàn	cliff barring the way/fig. brick wall
年限	年限	nián xiàn	age limit/fixed number of years
底限	底限	dǐ xiàn	lowest limit/bottom line
截止期限	截止期限	jié zhǐ qī xiàn	deadline
戶限	户限	hù xiàn	threshold
戶限為穿	户限为穿	hù xiàn wèi chuān	an endless stream of visitors (idiom)
技術所限	技术所限	jì shù suǒ xiàn	technical limitations
時限	时限	shí xiàn	time limit
最低限度	最低限度	zuì dī xiàn dù	minimum
最低限度理論	最低限度理论	zuì dī xiàn dù lǐ lùn	minimalist theory
最後期限	最后期限	zuì hòu qī xiàn	deadline/final time limit (for project)
最高工資限額	最高工资限额	zuì gāo gōng zī xiàn é	wage ceiling
最高限額	最高限额	zuì gāo xiàn é	maximum amount/ceiling/upper limit/quota
有限	有限	yǒu xiàn	limited/finite
有限元	有限元	yǒu xiàn yuán	finite element (method)
有限元法	有限元法	yǒu xiàn yuán fǎ	finite element method
有限公司	有限公司	yǒu xiàn gōng sī	limited company/corporation
有限單元	有限单元	yǒu xiàn dān yuán	finite element (method)
有限群	有限群	yǒu xiàn qún	finite group (math.)
有限集	有限集	yǒu xiàn jí	finite set
期限	期限	qī xiàn	time limit/deadline/allotted time
極限	极限	jí xiàn	limit/extreme boundary
極限運動	极限运动	jí xiàn yùn dòng	extreme sport
權限	权限	quán xiàn	scope of authority/extent of power/(access etc) privileges
每日限價	每日限价	měi rì xiàn jià	limit on daily price variation
汽車夏利股份有限公司	汽车夏利股份有限公司	Qì chē Xià lì gǔ fèn yǒu xiàn gōng sī	Tianjin FAW Xiali Motor Company, Ltd., established 1997
漲跌幅限制	涨跌幅限制	zhǎng diē fú xiàn zhì	limit up, limit down/limit on daily price variation
無限	无限	wú xiàn	unlimited/unbounded
無限制	无限制	wú xiàn zhì	limitless/unrestricted
無限小	无限小	wú xiàn xiǎo	infinitesimal/infinitely small
無限小數	无限小数	wú xiàn xiǎo shù	infinitesimal/infinite decimal expansion
無限期	无限期	wú xiàn qī	unlimited (time) duration
無限風光在險峰	无限风光在险峰	wú xiàn fēng guāng zài xiǎn fēng	The boundless vista is at the perilous peak (proverb)/fig. exhilaration follows a hard-won victory
物主限定詞	物主限定词	wù zhǔ xiàn dìng cí	possessive (in grammar)
界限	界限	jiè xiàn	boundary
畫地自限	画地自限	huà dì zì xiàn	lit. to draw a line on the ground to keep within (idiom)/fig. to impose restrictions on oneself
第一象限	第一象限	dì yī xiàng xiàn	first quadrant (of the coordinate plane, where both x and y are positive)
置信限	置信限	zhì xìn xiàn	confidence limit (math.)
股份有限公司	股份有限公司	gǔ fèn yǒu xiàn gōng sī	joint-stock limited company/corporation
見聞有限	见闻有限	jiàn wén yǒu xiàn	to possess limited experience and knowledge (idiom)
象限	象限	xiàng xiàn	quadrant (in coordinate geometry)
超過限度	超过限度	chāo guò xiàn dù	to exceed/to go beyond/to overstep the limit
超限戰	超限战	chāo xiàn zhàn	unrestricted warfare (originally the title of a Chinese book published in 1999, later used to refer to war by any means, military or non-military, including cyberwarfare, economic warfare etc)
門限	门限	mén xiàn	doorsill
上限	上限	shàng xiàn	upper bound
限價	限价	xiàn jià	limit on price
限制	限制	xiàn zhì	to restrict/to limit/to confine/restriction/limit/CL:個|个[gè]
限制酶	限制酶	xiàn zhì méi	restriction enzyme
限制酶圖譜	限制酶图谱	xiàn zhì méi tú pǔ	restriction mapping (in genomics)/restriction pattern
限定	限定	xiàn dìng	to restrict to/to limit
限定詞	限定词	xiàn dìng cí	determiner (in grammar, i.e. article, demonstrative, possessive pronoun, noun genitive etc)
限度	限度	xiàn dù	limitation/limit
限於	限于	xiàn yú	to be limited to/to be confined to
限時信	限时信	xiàn shí xìn	mail to be delivered by a specified time
限期	限期	xiàn qī	to set a time limit/time limit/deadline
限界線	限界线	xiàn jiè xiàn	boundary/dividing line
限速	限速	xiàn sù	speed limit
限高架	限高架	xiàn gāo jià	height restriction barrier
騰訊控股有限公司	腾讯控股有限公司	Téng xùn Kòng gǔ Yǒu xiàn Gōng sī	Tencent Holdings Limited (developers of the QQ instant messaging platform)
