輩	辈	bèi	lifetime/generation/group of people/class/classifier for generations/(literary) classifier for people
上輩	上辈	shàng bèi	ancestors/one's elders
上輩子	上辈子	shàng bèi zi	one's ancestors/past generations/a former incarnation
下輩	下辈	xià bèi	offspring/future generations/younger generation of a family/junior members of a group
下輩子	下辈子	xià bèi zi	the next life
先輩	先辈	xiān bèi	elders/former generations
八輩子	八辈子	bā bèi zi	(fig.) a long time
前輩	前辈	qián bèi	senior/older generation/precursor
半輩子	半辈子	bàn bèi zi	half of a lifetime
同輩	同辈	tóng bèi	of the same generation/person of the same generation/peer
吾輩	吾辈	wú bèi	(literary) we/us
小輩	小辈	xiǎo bèi	the younger generation
平庸之輩	平庸之辈	píng yōng zhī bèi	a nobody/a nonentity
平輩	平辈	píng bèi	of the same generation
後輩	后辈	hòu bèi	younger generation
我輩	我辈	wǒ bèi	(literary) we/us
晚輩	晚辈	wǎn bèi	the younger generation/those who come after
流輩	流辈	liú bèi	a contemporary/similar class of people
父執輩	父执辈	fù zhí bèi	person of one's father's generation
父輩	父辈	fù bèi	people of one's parents' generation
班輩	班辈	bān bèi	seniority in the family/pecking order
班輩兒	班辈儿	bān bèi r5	seniority in the family/pecking order
祖父輩	祖父辈	zǔ fù bèi	people of one's grandparents' generation
祖祖輩輩	祖祖辈辈	zǔ zǔ bèi bèi	for generations/from generation to generation
祖輩	祖辈	zǔ bèi	ancestors/forefathers/ancestry
等閒之輩	等闲之辈	děng xián zhī bèi	(in the negative) (not) to be trifled with
老一輩	老一辈	lǎo yī bèi	previous generation/older generation
老輩	老辈	lǎo bèi	the older generation/ancestors
行輩	行辈	háng bèi	generation and age ranking/seniority
一輩子	一辈子	yī bèi zi	(for) a lifetime
輩兒	辈儿	bèi r5	generation
輩出	辈出	bèi chū	to come forth in large numbers
輩分	辈分	bèi fèn	seniority in the family or clan/position in the family hierarchy
輩子	辈子	bèi zi	all one's life/lifetime
長輩	长辈	zhǎng bèi	one's elders/older generation
鼠輩	鼠辈	shǔ bèi	a scoundrel/a bad chap
