虛	虚	xū	emptiness/void/abstract theory or guiding principles/empty or unoccupied/diffident or timid/false/humble or modest/(of health) weak/virtual/in vain
乘虛	乘虚	chéng xū	to take advantage of weakness
乘虛而入	乘虚而入	chéng xū ér rù	to enter by exploiting a weak spot (idiom); to take advantage of a lapse
交換虛電路	交换虚电路	jiāo huàn xū diàn lù	Switched Virtual Circuit/SVC
以虛帶實	以虚带实	yǐ xū dài shí	to let correct ideology guide practical work (idiom)
做賊心虛	做贼心虚	zuò zéi xīn xū	to feel guilty as a thief (idiom); to have sth on one's conscience
共軛虛數	共轭虚数	gòng è xū shù	conjugate imaginary number (math)
務虛	务虚	wù xū	to discuss guidelines/to discuss principles to be followed
名不虛傳	名不虚传	míng bù xū chuán	lit. name is not in vain (idiom); a fully justified reputation/enjoys a well-deserved reputation
向壁虛構	向壁虚构	xiàng bì xū gòu	facing a wall, an imaginary construction (idiom); baseless fabrication
向壁虛造	向壁虚造	xiàng bì xū zào	facing a wall, an imaginary construction (idiom); baseless fabrication
太虛	太虚	Tài xū	Taixu (famed Buddhist monk, 1890-1947)
太虛	太虚	tài xū	great emptiness/the void/heaven/the skies/universe/cosmos/original essence of the cosmos
座無虛席	座无虚席	zuò wú xū xí	lit. a banquet with no empty seats/full house/capacity crowd/standing room only
弄虛作假	弄虚作假	nòng xū zuò jiǎ	to practice fraud (idiom); by trickery
張若虛	张若虚	Zhāng Ruò xū	Zhang Ruoxu (c. 660-720), Tang dynasty poet, author of yuefu poem River on a spring night 春江花月夜
形同虛設	形同虚设	xíng tóng xū shè	to exist in name only/empty shell/useless (idiom)
徒擁虛名	徒拥虚名	tú yōng xū míng	to possess an undeserved reputation (idiom)
徒有虛名	徒有虚名	tú yǒu xū míng	with an undeserved reputation (idiom); unwarranted fame/nowhere near as good as he's made out to be
心虛	心虚	xīn xū	lacking in confidence/diffident/to have a guilty conscience
愛慕虛榮	爱慕虚荣	ài mù xū róng	vain
故弄玄虛	故弄玄虚	gù nòng xuán xū	deliberately mystifying/to make sth unnecessarily complicated
氣虛	气虚	qì xū	deficiency of 氣|气[qì] (TCM)
永久虛電路	永久虚电路	yǒng jiǔ xū diàn lù	Permanent Virtual Circuit/PVC
浪得虛名	浪得虚名	làng dé xū míng	to have an undeserved reputation (idiom)
深藏若虛	深藏若虚	shēn cáng ruò xū	to hide one's treasure away so that no-one knows about it (idiom); fig. modest about one's talents/to hide one's light under a bushel
玄虛	玄虚	xuán xū	deceitful trick/mystery/unfathomable
發虛	发虚	fā xū	to feel weak/to be diffident
眼見為實，耳聽為虛	眼见为实，耳听为虚	yǎn jiàn wéi shí , ěr tīng wéi xū	to believe what one sees, not what one hears (idiom). Don't believe what people tell you until you see if for yourself./It ain't necessarily so.
空虛	空虚	kōng xū	hollow/emptiness/meaningless
耳聽為虛，眼見為實	耳听为虚，眼见为实	ěr tīng wéi xū , yǎn jiàn wéi shí	Take what you hear to be false, only believe it when you see it (idiom). Don't believe what people tell you until you see if for yourself./It ain't necessarily so.
背景虛化	背景虚化	bèi jǐng xū huà	background blurring (photography)
脾虛	脾虚	pí xū	depletion of the spleen (Chinese medicine)
不虛此行	不虚此行	bù xū cǐ xíng	the trip has not been made in vain/the trip has been well worthwhile/it's been a worthwhile trip
虛不受補	虚不受补	xū bù shòu bǔ	a person who is in poor health cannot handle sth so strong as a tonic
虛位以待	虚位以待	xū wèi yǐ dài	to reserve a seat/to leave a position vacant
虛假	虚假	xū jiǎ	false/phony/pretense
虛偽	虚伪	xū wěi	false/hypocritical/artificial/sham
虛偽類真	虚伪类真	xū wěi lèi zhēn	false but apparently real
虛像	虚像	xū xiàng	virtual image
虛名	虚名	xū míng	false reputation
虛報	虚报	xū bào	to misreport/fraudulent report
虛妄	虚妄	xū wàng	fabricated
虛客族	虚客族	xū kè zú	people who like to window-shop for unaffordable luxuries
虛宮格	虚宫格	xū gōng gé	four-square box in which one practices writing a Chinese character
虛實	虚实	xū shí	what is true and what is false/(to get to know) the real situation
虛己以聽	虚己以听	xū jǐ yǐ tīng	to listen to the ideas of others with an open mind (idiom)
虛席以待	虚席以待	xū xí yǐ dài	to reserve a seat for sb (idiom)
虛幻	虚幻	xū huàn	imaginary/illusory
虛度	虚度	xū dù	to fritter away (one's time)
虛度光陰	虚度光阴	xū dù guāng yīn	to waste time on worthless activities
虛弱	虚弱	xū ruò	weak/in poor health
虛張聲勢	虚张声势	xū zhāng shēng shì	(false) bravado/to bluff
虛心	虚心	xū xīn	open-minded/humble
虛心使人進步，驕傲使人落後	虚心使人进步，骄傲使人落后	xū xīn shǐ rén jìn bù , jiāo ào shǐ rén luò hòu	Modesty leads to progress, arrogance makes you drop behind (favorite slogan of Mao Zedong)
虛心好學	虚心好学	xū xīn hào xué	modest and studious (idiom)
虛情假意	虚情假意	xū qíng jiǎ yì	false friendship/hypocritical show of affection
虛應了事	虚应了事	xū yìng liǎo shì	see 虛應故事|虚应故事[xū yìng gù shì]
虛應故事	虚应故事	xū yìng gù shì	to go through the motions
虛懷若谷	虚怀若谷	xū huái ruò gǔ	receptive as an echoing canyon (idiom); modest and open-minded
虛損	虚损	xū sǔn	(TCM) consumptive disease, chronic deficiency disorder due to impaired function of inner organs, deficiency of qi, blood, yin and yang/asthenia
虛擬	虚拟	xū nǐ	to imagine/to make up/fictitious/theoretical/hypothetical/(computing) to emulate/virtual
虛擬實境	虚拟实境	xū nǐ shí jìng	virtual reality (Tw)
虛擬專用網絡	虚拟专用网络	xū nǐ zhuān yòng wǎng luò	virtual private network (VPN)
虛擬機	虚拟机	xū nǐ jī	virtual machine
虛擬現實	虚拟现实	xū nǐ xiàn shí	virtual reality
虛擬現實置標語言	虚拟现实置标语言	xū nǐ xiàn shí zhì biāo yǔ yán	virtual reality markup language (VRML) (computing)
虛擬環境	虚拟环境	xū nǐ huán jìng	virtual environment
虛擬私人網絡	虚拟私人网络	xū nǐ sī rén wǎng luò	virtual private network (VPN)
虛擬網絡	虚拟网络	xū nǐ wǎng luò	virtual network
虛擬語氣	虚拟语气	xū nǐ yǔ qì	subjunctive mood (grammar)
虛擬連接	虚拟连接	xū nǐ lián jiē	virtual connection
虛數	虚数	xū shù	imaginary number
虛文	虚文	xū wén	dead letter/rule no longer in force/empty formality
虛文浮禮	虚文浮礼	xū wén fú lǐ	empty formality
虛星	虚星	xū xīng	imaginary star (in astrology)
虛有其表	虚有其表	xū yǒu qí biǎo	looks impressive but is worthless (idiom)/not as good as it looks/a reputation with no substance
虛榮	虚荣	xū róng	vanity
虛榮心	虚荣心	xū róng xīn	vanity
虛構	虚构	xū gòu	to make up/fabrication/fictional/imaginary
虛構小說	虚构小说	xū gòu xiǎo shuō	fiction
虛歲	虚岁	xū suì	one's age, according to the traditional Chinese method of reckoning (i.e. the number of Chinese calendar years in which one has lived). In this system, a person's age is one year at birth, and increases by one year at the beginning of the first solar term 立春[Lì chūn] each year, rather than on one's birthday./as opposed to 足歲|足岁[zú suì]/see also 實歲|实岁[shí suì]
虛火	虚火	xū huǒ	excess of internal heat due to poor general condition (TCM)/the prestige of another person, which one borrows for oneself
虛無	虚无	xū wú	nothingness
虛無主義	虚无主义	xū wú zhǔ yì	nihilism
虛無假設	虚无假设	xū wú jiǎ shè	null hypothesis (statistics)
虛無縹緲	虚无缥缈	xū wú piǎo miǎo	unreal/illusory/imaginary/vague and with nothing in it
虛發	虚发	xū fā	to miss the target (with a bullet or an arrow)
虛空	虚空	xū kōng	void/hollow/empty
虛空藏菩薩	虚空藏菩萨	Xū kōng zàng Pú sà	Akasagarbha Bodhisattva
虛粒子	虚粒子	xū lì zǐ	virtual particle
虛線	虚线	xū xiàn	dotted line/dashed line/(math.) imaginary line
虛缺號	虚缺号	xū quē hào	white square character ( □ ), used to represent a missing ideograph
虛脫	虚脱	xū tuō	to collapse (from dehydration or loss of blood)/heat exhaustion
虛腕	虚腕	xū wàn	empty wrist (method of painting)
虛與委蛇	虚与委蛇	xū yǔ wēi yí	to feign civility (idiom)
虛虛實實	虚虚实实	xū xū shí shí	hard to tell if it's real or sham
虛言	虚言	xū yán	empty words/false words
虛詐	虚诈	xū zhà	tricky and hypocritical
虛詞	虚词	xū cí	(linguistics) function word
虛誇	虚夸	xū kuā	to boast/to brag/boastful/exaggerative/pompous/bombastic
虛謊	虚谎	xū huǎng	false
虛警	虚警	xū jǐng	false alert
虛譽	虚誉	xū yù	imaginary reputation/empty fame
虛電路	虚电路	xū diàn lù	virtual circuit/VC
虛頭	虚头	xū tóu	to play tricks/to deceive
虛飄飄	虚飘飘	xū piāo piāo	light and airy/floating
虛驚	虚惊	xū jīng	false alarm/panic rumor/CL:場|场[cháng]
謙虛	谦虚	qiān xū	modest/self-effacing/to make modest remarks
避實就虛	避实就虚	bì shí jiù xū	(idiom) stay clear of the enemy's main force and strike at his weak points
陰虛	阴虚	yīn xū	deficiency of yin 陰|阴[yīn] in TCM
陰虛火旺	阴虚火旺	yīn xū huǒ wàng	an excess of heat caused by a deficiency in Yin energy (idiom)
