刦	劫	jié	variant of 劫[jié]
刧	劫	jié	variant of 劫[jié]
刼	劫	jié	variant of 劫[jié]
劫	劫	jié	to rob/to plunder/to seize by force/to coerce/calamity/abbr. for kalpa 劫波[jié bō]
乘火打劫	乘火打劫	chéng huǒ dǎ jié	to take advantage of sb's misfortune/to loot
劫匪	劫匪	jié fěi	bandit/robber
劫囚	劫囚	jié qiú	to break a prisoner out of jail
劫奪	劫夺	jié duó	to seize by force/to abduct
劫富濟貧	劫富济贫	jié fù jì pín	to rob the rich to help the poor
劫寨	劫寨	jié zhài	to seize a stronghold/to surprise the enemy in his camp
劫後餘生	劫后余生	jié hòu yú shēng	after the calamity, renewed life (idiom); new lease of life
劫持	劫持	jié chí	to kidnap/to hijack/to abduct/to hold under duress
劫持者	劫持者	jié chí zhě	hijacker/kidnapper
劫掠	劫掠	jié lüè	to loot/to plunder
劫數	劫数	jié shù	predestined fate (Buddhism)
劫數難逃	劫数难逃	jié shù nán táo	Destiny is inexorable, there is no fleeing it (idiom). Your doom is at hand.
劫機	劫机	jié jī	hijacking/air piracy
劫殺	劫杀	jié shā	to rob and kill
劫波	劫波	jié bō	kalpa (loanword) (Hinduism)
劫洗	劫洗	jié xǐ	to loot/plunder
劫營	劫营	jié yíng	to seize a camp/to surprise the enemy in bed
劫獄	劫狱	jié yù	to break into jail/to forcibly release prisoners
劫車	劫车	jié chē	to carjack/carjacking
劫道	劫道	jié dào	to kidnap/to hijack
劫難	劫难	jié nàn	calamity
劫餘	劫余	jié yú	remnants after a disaster/aftermath
打劫	打劫	dǎ jié	to loot/to rob/to plunder/to ransack
打家劫舍	打家劫舍	dǎ jiā jié shè	to break into a house for robbery (idiom)
持槍搶劫	持枪抢劫	chí qiāng qiāng jié	armed robbery
搶劫	抢劫	qiǎng jié	to rob/looting
搶劫案	抢劫案	qiǎng jié àn	robbery/holdup
搶劫罪	抢劫罪	qiāng jié zuì	robbery
攔劫	拦劫	lán jié	to mug/to intercept and rob
洗劫	洗劫	xǐ jié	to loot/to rob/to ransack/to pillage
洗劫一空	洗劫一空	xǐ jié yī kōng	to steal everything
浩劫	浩劫	hào jié	calamity/catastrophe/apocalypse
紅羊劫	红羊劫	hóng yáng jié	national disaster (ancient astrological allusion)
萬劫不復	万劫不复	wàn jié bù fù	consigned to eternal damnation/with no hope of reprieve
趁火打劫	趁火打劫	chèn huǒ dǎ jié	to loot a burning house/to profit from sb's misfortune (idiom)
