條	条	tiáo	strip/item/article/clause (of law or treaty)/classifier for long thin things (ribbon, river, road, trousers etc)
一條繩上的螞蚱	一条绳上的蚂蚱	yī tiáo shéng shàng de mà zha	lit. grasshoppers tied together with a piece of string (idiom)/fig. people who are in it together for better or worse/people who will sink or swim together
一條路走到黑	一条路走到黑	yī tiáo lù zǒu dào hēi	lit. to follow one road until dark (idiom)/fig. to stick to one's ways/to cling to one's course
一條道走到黑	一条道走到黑	yī tiáo dào zǒu dào hēi	to stick to one's ways/to cling to one's course
一條龍	一条龙	yī tiáo lóng	lit. one dragon/integrated chain/coordinated process
一條龍服務	一条龙服务	yī tiáo lóng fú wù	one-stop service
三條	三条	sān tiáo	three of a kind (poker)
不平等條約	不平等条约	bù píng děng tiáo yuē	unequal treaty
不擴散核武器條約	不扩散核武器条约	Bù Kuò sàn Hé wǔ qì Tiáo yuē	Treaty on the Non-Proliferation of Nuclear Weapons
並條	并条	bìng tiáo	drawing (textile industry)
中俄伊犁條約	中俄伊犁条约	Zhōng É Yī lí Tiáo yuē	Treaty of Saint Petersburg of 1881, whereby Russia handed back Yili province to Qing China in exchange for compensation payment and unequal treaty rights
中俄北京條約	中俄北京条约	Zhōng É Běi jīng Tiáo yuē	the Treaty of Beijing of 1860 between Qing China and Tsarist Russia
中俄尼布楚條約	中俄尼布楚条约	Zhōng É Ní bù chǔ Tiáo yuē	Treaty of Nerchinsk (1698) between Qing China and Russia
中俄改訂條約	中俄改订条约	Zhōng É Gǎi dìng Tiáo yuē	Treaty of Saint Petersburg of 1881, whereby Russia handed back Yili province to Qing China in exchange for compensation payment and unequal treaty rights
二十一條	二十一条	Èr shí yī Tiáo	the Japanese Twenty-One Demands of 1915
井井有條	井井有条	jǐng jǐng yǒu tiáo	everything clear and orderly (idiom); neat and tidy
今日頭條	今日头条	Jīn rì Tóu tiáo	Toutiao, personalized content recommendation app
付款條件	付款条件	fù kuǎn tiáo jiàn	terms of payment
使用條款	使用条款	shǐ yòng tiáo kuǎn	terms of use
便條	便条	biàn tiáo	(informal) note/CL:張|张[zhāng],個|个[gè]
便條紙	便条纸	biàn tiáo zhǐ	scrap paper
信條	信条	xìn tiáo	creed/article of faith
借條	借条	jiè tiáo	receipt for a loan/IOU
假條	假条	jià tiáo	leave of absence request (from work or school)/excuse note/CL:張|张[zhāng]
充要條件	充要条件	chōng yào tiáo jiàn	necessary and sufficient condition
先決條件	先决条件	xiān jué tiáo jiàn	precondition/prerequisite
免責條款	免责条款	miǎn zé tiáo kuǎn	disclaimer
免賠條款	免赔条款	miǎn péi tiáo kuǎn	franchise clause (insurance)
全面禁止核試驗條約	全面禁止核试验条约	Quán miàn Jìn zhǐ Hé shì yàn Tiáo yuē	Comprehensive Nuclear-Test-Ban Treaty
冗條子	冗条子	rǒng tiáo zi	unwanted branches (of a tree etc)
前提條件	前提条件	qián tí tiáo jiàn	preconditions
半條命	半条命	bàn tiáo mìng	half a life/only half alive/barely alive/(scared, beaten etc) half to death
南京條約	南京条约	Nán jīng Tiáo yuē	Treaty of Nanjing (1842) that concluded the First Opium War between Qing China and Britain
口條	口条	kǒu tiáo	(ox etc) tongue (as food)/(Tw) elocution/articulation
和平條約	和平条约	hé píng tiáo yuē	peace treaty
四條	四条	sì tiáo	four of a kind/quads (poker)
回條	回条	huí tiáo	receipt/note acknowledging receipt
報條	报条	bào tiáo	report of success from a candidate to the imperial examination (old)/list of deaths
墨條	墨条	mò tiáo	ink stick
多個朋友多條路	多个朋友多条路	duō gè péng yǒu duō tiáo lù	the more friends you have, the more options you have in life (idiom)
大條	大条	dà tiáo	(used to modify 事情[shì qing]) serious/grave
大蕭條	大萧条	Dà Xiāo tiáo	the Great Depression (1929-c. 1939)
天津會議專條	天津会议专条	Tiān jīn huì yì zhuān tiáo	Tianjin agreement of 1885 between Li Hongzhang 李鴻章|李鸿章[Lǐ Hóng zhāng] and ITŌ Hirobumi 伊藤博文[Yī téng Bó wén] to pull Qing and Japanese troops out of Korea
天津條約	天津条约	Tiān jīn Tiáo yuē	Treaty of Tianjin of 1858, a sequence of unequal treaties 不平等條約|不平等条约 between Russia, USA, England, France and Qing China
字條	字条	zì tiáo	brief note
封條	封条	fēng tiáo	seal
尼布楚條約	尼布楚条约	Ní bù chǔ Tiáo yuē	Treaty of Nerchinsk (1698) between Qing China and Russia
屏條	屏条	píng tiáo	set of (usually four) hanging scrolls
工具條	工具条	gōng jù tiáo	toolbar (in computer software)
廣告條幅	广告条幅	guǎng gào tiáo fú	banner advertisement
律條	律条	lǜ tiáo	a law
必要條件	必要条件	bì yào tiáo jiàn	requirement/necessary condition (math)
慢條斯理	慢条斯理	màn tiáo sī lǐ	unhurried/calm/composed/leisurely
憑條	凭条	píng tiáo	paper docket confirming a transaction
戒條	戒条	jiè tiáo	commandment/precept
打白條	打白条	dǎ bái tiáo	to write an IOU or promissory note
扯皮條	扯皮条	chě pí tiáo	see 拉皮條|拉皮条[lā pí tiáo]
拉大條	拉大条	lā dà tiáo	to defecate (slang)
拉白布條	拉白布条	lā bái bù tiáo	to hold up a white banner (i.e. to protest)
拉皮條	拉皮条	lā pí tiáo	to procure/to act as pimp
拉薩條約	拉萨条约	Lā sà Tiáo yuē	Treaty of Lhasa (1904) between British empire and Tibet
撇大條	撇大条	piě dà tiáo	(slang) to take a dump
撇條	撇条	piě tiáo	(slang) to go to the toilet
收條	收条	shōu tiáo	receipt
改訂伊犁條約	改订伊犁条约	Gǎi dìng Yī lí Tiáo yuē	Treaty of Saint Petersburg of 1881 in which Russia agreed to hand back Yili province to Qing China in exchange for compensation payment and unequal treaty rights
教條	教条	jiào tiáo	doctrine/dogma/creed/dogmatic
教條主義	教条主义	jiào tiáo zhǔ yì	dogmatism
整條	整条	zhěng tiáo	entire/whole (fish, road etc)
旅大租地條約	旅大租地条约	Lǚ Dà Zū dì Tiáo yuē	unequal treaty of 1898 whereby the Qing dynasty ceded the lease of Lüshun (Port Arthur) to Russia
星條旗	星条旗	xīng tiáo qí	Stars and Stripes, the flag of the United States
有條不紊	有条不紊	yǒu tiáo bù wěn	regular and thorough (idiom); methodically arranged
有條有理	有条有理	yǒu tiáo yǒu lǐ	everything clear and orderly (idiom); neat and tidy
有條有理地	有条有理地	yǒu tiáo yǒu lǐ de	methodically/systematically
有條紋	有条纹	yǒu tiáo wén	striped
東條英機	东条英机	Dōng tiáo Yīng jī	Tojo Hideki (1884-1948), Japanese military leader hanged as war criminal in 1948
板條	板条	bǎn tiáo	lath
板條箱	板条箱	bǎn tiáo xiāng	crate
枝條	枝条	zhī tiáo	branch/twig/stem
柳條	柳条	liǔ tiáo	willow/willow branches/wicker (material for basketwork)
柳條湖事件	柳条湖事件	Liǔ tiáo Hú Shì jiàn	the Mukden or Manchurian Railway Incident of 18th September 1931 used by the Japanese as a pretext to annex Manchuria/also known as 9-18 incident 九一八事變|九一八事变[Jiǔ Yī bā Shì biàn]
柳條溝事件	柳条沟事件	Liǔ tiáo Gōu Shì jiàn	see 柳條湖事件|柳条湖事件[Liǔ tiáo Hú Shì jiàn]
柳條邊	柳条边	liǔ tiáo biān	Willow palisade across Liaoning, 17th century barrier
柵條	栅条	zhà tiáo	paling/fence rail
一條心	一条心	yī tiáo xīn	to be of one mind/to think or act alike
條件	条件	tiáo jiàn	condition/circumstances/term/factor/requirement/prerequisite/qualification/CL:個|个[gè]
條件反射	条件反射	tiáo jiàn fǎn shè	conditioned reflex
條件反應	条件反应	tiáo jiàn fǎn yìng	conditioned response
條件句	条件句	tiáo jiàn jù	conditional clause
條件式	条件式	tiáo jiàn shì	conditional
條件概率	条件概率	tiáo jiàn gài lǜ	conditional probability
條例	条例	tiáo lì	regulations/rules/code of conduct/ordinances/statutes
條凳	条凳	tiáo dèng	bench
條分縷析	条分缕析	tiáo fēn lǚ xī	to analyze thoroughly, point by point (idiom)
條子	条子	tiáo zi	short note/slip of paper/stripe/(slang) cop/(old) prostitute
條幅	条幅	tiáo fú	wall scroll (for painting or calligraphy)/banner
條幅廣告	条幅广告	tiáo fú guǎng gào	banner advertisement
條幾	条几	tiáo jī	long narrow table
條形	条形	tiáo xíng	a bar/a strip
條形圖	条形图	tiáo xíng tú	bar chart
條形燃料	条形燃料	tiáo xíng rán liào	fuel rods
條形碼	条形码	tiáo xíng mǎ	barcode
條播	条播	tiáo bō	to drill (i.e. plant seeds in spaced rows)
條文	条文	tiáo wén	clause/explanatory section in a document
條斑竊蠹	条斑窃蠹	tiáo bān qiè dù	furniture beetle
條暢	条畅	tiáo chàng	orderly and logical (of writing)/luxuriant/flourishing/prosperous
條板箱	条板箱	tiáo bǎn xiāng	crate
條案	条案	tiáo àn	long narrow table
條條大路通羅馬	条条大路通罗马	tiáo tiáo dà lù tōng Luó mǎ	all roads lead to Rome/use different means to obtain the same result (idiom)
條條框框	条条框框	tiáo tiáo kuàng kuàng	fixed framework (idiom); restriction of social conventions and taboos (usually derogatory)/regulations and restrictions
條款	条款	tiáo kuǎn	clause (of contract or law)/CL:項|项[xiàng]
條理	条理	tiáo lǐ	arrangement/order/tidiness
條痕	条痕	tiáo hén	weal (e.g. from whipping)/streak
條目	条目	tiáo mù	clauses and sub-clauses (in formal document)/entry (in a dictionary, encyclopedia etc)
條碼	条码	tiáo mǎ	barcode
條約	条约	tiáo yuē	treaty/pact/CL:個|个[gè]
條紋	条纹	tiáo wén	stripe
條紋噪鶥	条纹噪鹛	tiáo wén zào méi	(bird species of China) striated laughingthrush (Garrulax striatus)
條規	条规	tiáo guī	rule
條貫	条贯	tiáo guàn	system/sequence/order/procedures
條陳	条陈	tiáo chén	to lay out (an argument) item by item/memorandum to a superior
棉條	棉条	mián tiáo	tampon/sliver (textiles)
樣條函數	样条函数	yàng tiáo hán shù	spline function (math.)
欠條	欠条	qiàn tiáo	IOU/certificate of indebtedness
死路一條	死路一条	sǐ lù yī tiáo	(idiom) dead end/road to ruin
毛條	毛条	máo tiáo	wool top, semiprocessed raw wool
油條	油条	yóu tiáo	youtiao (deep-fried breadstick)/CL:根[gēn]/slick and sly person
沿條兒	沿条儿	yán tiáo r5	tape seam (in dressmaking)/tape trim
滾動條	滚动条	gǔn dòng tiáo	scrollbar (computing)
炸土豆條	炸土豆条	zhá tǔ dòu tiáo	french fries/(hot) potato chips
炸土豆條兒	炸土豆条儿	zhá tǔ dòu tiáo r5	erhua variant of 炸土豆條|炸土豆条[zhá tǔ dòu tiáo]
炸薯條	炸薯条	zhá shǔ tiáo	french fries
無條件	无条件	wú tiáo jiàn	unconditional
無條件投降	无条件投降	wú tiáo jiàn tóu xiáng	unconditional surrender
璦琿條約	瑷珲条约	Ài hún Tiáo yuē	Treaty of Aigun, 1858 unequal treaty forced on Qing China by Tsarist Russia
病假條	病假条	bìng jià tiáo	sick note/medical certificate for sick leave
發條	发条	fā tiáo	spring/coil spring (spiral spring used to power clockwork)
白條	白条	bái tiáo	IOU/informal document acknowledging a debt
皮條	皮条	pí tiáo	thong/leather strap/pimp/procurer
皮條客	皮条客	pí tiáo kè	pimp
相容條件	相容条件	xiāng róng tiáo jiàn	conditions for consistency
碎布條	碎布条	suì bù tiáo	shred
磁條	磁条	cí tiáo	magnetic stripe
神經大條	神经大条	shén jīng dà tiáo	thick-skinned/insensitive
禁止核武器試驗條約	禁止核武器试验条约	jìn zhǐ hé wǔ qì shì yàn tiáo yuē	nuclear test ban treaty
穿一條褲子	穿一条裤子	chuān yī tiáo kù zi	(of male friends) to have been through thick and thin together/to be like family/to share the same view of things
競業條款	竞业条款	jìng yè tiáo kuǎn	non-compete clause (law)
籤條	签条	qiān tiáo	label/tag
粉條	粉条	fěn tiáo	vermicelli made from mung bean starch etc
約束條件	约束条件	yuē shù tiáo jiàn	restrictive condition/constraint
紙條	纸条	zhǐ tiáo	slip of paper
經濟蕭條	经济萧条	jīng jì xiāo tiáo	economic depression
線條	线条	xiàn tiáo	line (in drawing, calligraphy etc)/the lines or contours of a three-dimensional object (hairstyle, clothing, car etc)
老油條	老油条	lǎo yóu tiáo	old fox/slick customer
肉條	肉条	ròu tiáo	cutlet
腳踏兩條船	脚踏两条船	jiǎo tà liǎng tiáo chuán	lit. to stand with each foot in a different boat (idiom)/fig. to have it both ways/to run after two hares/(especially) to have two lovers at the same time
自然條件	自然条件	zì rán tiáo jiàn	natural conditions
艾條	艾条	ài tiáo	moxa stick, moxa roll (TCM)
艾條溫和灸	艾条温和灸	ài tiáo wēn hé jiǔ	gentle stick moxibustion (TCM)
艾條灸	艾条灸	ài tiáo jiǔ	stick moxibustion/poling (TCM)
艾條雀啄灸	艾条雀啄灸	ài tiáo què zhuó jiǔ	"sparrow pecking" moxibustion technique (TCM)
苗條	苗条	miáo tiao	(of a woman) slim/slender/graceful
菜單條	菜单条	cài dān tiáo	menu bar (of a computer application)
蕭條	萧条	xiāo tiáo	bleak/desolate/(economic) depression or slump
薯條	薯条	shǔ tiáo	french fries/french fried potatoes/chips
藤條	藤条	téng tiáo	rattan
衛生棉條	卫生棉条	wèi shēng mián tiáo	tampon
規條	规条	guī tiáo	regulations
訓條	训条	xùn tiáo	instruction/order/maxim
詞條	词条	cí tiáo	dictionary entry/lexical item/term
請假條	请假条	qǐng jià tiáo	leave of absence request (from work or school)
赤條條	赤条条	chì tiáo tiáo	stark naked
路條	路条	lù tiáo	travel pass
車條	车条	chē tiáo	spoke (of wheel)
軋鋼條	轧钢条	zhá gāng tiáo	steel rails
輻條	辐条	fú tiáo	(wheel) spoke
辛丑條約	辛丑条约	Xīn chǒu Tiáo yuē	Boxer Protocol of 1901 signed in Beijing, ending the Eight-power Allied Force intervention after the Boxer uprising
辣條	辣条	là tiáo	spicy sticks, a snack food similar to beef jerky but made with flour or dried beancurd instead of meat
遞條子	递条子	dì tiáo zi	to pass a message
里瓦幾亞條約	里瓦几亚条约	Lǐ wǎ jī yà Tiáo yuē	Treaty of Livadia (1879) between Russia and China, relating to territory in Chinese Turkistan, renegotiated in 1881 (Treaty of St. Petersburg)
金條	金条	jīn tiáo	gold bar
鉛條	铅条	qiān tiáo	strip of lead
銀條	银条	yín tiáo	silver bar
鋸條	锯条	jù tiáo	a sawblade
鋼條	钢条	gāng tiáo	steel bar
鏈條	链条	liàn tiáo	chain/CL:根[gēn],條|条[tiáo]
長條	长条	cháng tiáo	strip
集體安全條約組織	集体安全条约组织	Jí tǐ Ān quán Tiáo yuē Zǔ zhī	Collective Security Treaty Organization (CSTO)
雪條	雪条	xuě tiáo	ice lolly/popsicle
霜條	霜条	shuāng tiáo	popsicle
非條件反射	非条件反射	fēi tiáo jiàn fǎn shè	unconditioned reflex (physiology)
頭條	头条	Tóu tiáo	Toutiao, personalized content recommendation app (abbr. for 今日頭條|今日头条[Jīn rì Tóu tiáo])
頭條	头条	tóu tiáo	lead story (on the news)
頭條新聞	头条新闻	tóu tiáo xīn wén	top news story
馬關條約	马关条约	Mǎ guān Tiáo yuē	Treaty of Shimonoseki (1895), concluding the First Sino-Japanese War 甲午戰爭|甲午战争[Jiǎ wǔ Zhàn zhēng]
麵條	面条	miàn tiáo	noodles
麵條兒	面条儿	miàn tiáo r5	erhua variant of 麵條|面条[miàn tiáo]
齒條	齿条	chǐ tiáo	rack (and pinion)
齒條千斤頂	齿条千斤顶	chǐ tiáo qiān jīn dǐng	rack and pinion jack
齒條齒輪	齿条齿轮	chǐ tiáo chǐ lún	rack and pinion
