市	市	shì	market/city/CL:個|个[gè]
三亞市	三亚市	Sān yà shì	Sanya prefecture level city, Hainan
三明市	三明市	Sān míng shì	Sanming prefecture level city in Fujian
三河市	三河市	Sān hé shì	Sanhe county level city in Langfang 廊坊[Láng fáng], Hebei
三藩市	三藩市	Sān fān shì	San Francisco (California)
三重市	三重市	Sān chóng shì	Sanchong or Sanch'ung city in New Taipei City 新北市[Xīn běi shì], Taiwan
三門峽市	三门峡市	Sān mén xiá shì	Sanmenxia prefecture level city in Henan
上市	上市	shàng shì	to hit the market (of a new product)/to float (a company on the stock market)
上市公司	上市公司	shàng shì gōng sī	listed company
上海市	上海市	Shàng hǎi shì	Shanghai municipality in southeast China, abbr. 滬|沪
上虞市	上虞市	Shàng yú shì	Shangyu county level city in Shaoxing 紹興|绍兴[Shào xīng], Zhejiang
上饒市	上饶市	Shàng ráo shì	Shangrao prefecture level city in Jiangxi
下關市	下关市	Xià guān Shì	Shimonoseki, city in Yamaguchi Prefecture, Japan
中和市	中和市	Zhōng hé shì	Zhonghe or Chungho city in New Taipei City 新北市[Xīn běi shì], Taiwan
中壢市	中坜市	Zhōng lì shì	Zhongli or Chungli city in Taoyuan county 桃園縣|桃园县[Táo yuán xiàn], north Taiwan
中央直轄市	中央直辖市	zhōng yāng zhí xiá shì	municipality, namely: Beijing 北京, Tianjin 天津, Shanghai 上海 and Chongqing 重慶|重庆, the first level administrative subdivision/province level city/also called directly governed city
中山市	中山市	Zhōng shān shì	Zhongshan prefecture-level city in Guangdong province 廣東省|广东省[Guǎng dōng shěng] in south China, close to Dr Sun Yat-sen's birthplace
中衛市	中卫市	Zhōng wèi shì	Zhongwei prefecture level city in Ningxia
丹東市	丹东市	Dān dōng shì	Dandong prefecture-level city in Liaoning province 遼寧省|辽宁省 in northeast China
丹江口市	丹江口市	Dān jiāng kǒu shì	Danjiangkou county level city in Shiyan 十堰[Shí yàn], Hubei
丹陽市	丹阳市	Dān yáng shì	Danyang county level city in Zhenjiang 鎮江|镇江[Zhèn jiāng], Jiangsu
九江市	九江市	Jiǔ jiāng shì	Jiujiang prefecture-level city in Jiangxi
乳山市	乳山市	Rǔ shān shì	Rushan county level city in Weihai 威海, Shandong
二連浩特市	二连浩特市	Èr lián hào tè shì	Erlianhaote city in Xilin Gol league 錫林郭勒盟|锡林郭勒盟[Xī lín guō lè méng], Inner Mongolia
五大連池市	五大连池市	Wǔ dà lián chí shì	Wudalianchi county level city in Heihe 黑河[Hēi hé], Heilongjiang
五家渠市	五家渠市	Wǔ jiā qú shì	Wujyachü shehiri (Wujiaqu city) or Wǔjiāqú subprefecture level city in Ili Kazakh autonomous prefecture in north Xinjiang
五常市	五常市	Wǔ cháng shì	Wuchang county level city in Harbin 哈爾濱|哈尔滨, Heilongjiang
五指山市	五指山市	Wǔ zhǐ shān shì	Wuzhishan City, Hainan
五臺市	五台市	Wǔ tái shì	Wutai city in Shanxi
井岡山市	井冈山市	Jǐng gāng shān shì	Jinggangshan county level city in Ji'an 吉安, Jiangxi
交易市場	交易市场	jiāo yì shì chǎng	exchange/trading floor
亳州市	亳州市	Bó zhōu shì	Bozhou prefecture-level city in Anhui
什邡市	什邡市	Shí fāng shì	Shifang county level city in Deyang 德陽|德阳[Dé yáng], Sichuan
仁川市	仁川市	Rén chuān shì	Incheon Metropolitan City in Gyeonggi Province 京畿道[Jīng jī dào], South Korea
仁川廣域市	仁川广域市	Rén chuān Guǎng yù shì	Incheon Metropolitan City in Gyeonggi Province 京畿道[Jīng jī dào], South Korea
仁懷市	仁怀市	Rén huái shì	Renhuai county level city in Zunyi 遵義|遵义[Zūn yì], Guizhou
介休市	介休市	Jiè xiū shì	Jiexiu county level city in Jinzhong 晉中|晋中[Jìn zhōng], Shanxi
仙桃市	仙桃市	Xiān táo shì	Xiantao sub-prefecture level city in Hubei
任丘市	任丘市	Rén qiū Shì	Renqiu county level city in Cangzhou 滄州|沧州[Cāng zhōu], Hebei
伊寧市	伊宁市	Yī níng shì	Gulja or Yining city in Xinjiang, capital of Ili Kazakh autonomous prefecture
伊春市	伊春市	Yī chūn shì	Yichun prefecture level city in Heilongjiang province 黑龍江|黑龙江[Hēi lóng jiāng] in northeast China
休市	休市	xiū shì	to close the market (for a holiday or overnight etc)
佛山市	佛山市	Fó shān shì	Foshan prefecture-level city in Guangdong 廣東省|广东省[Guǎng dōng shěng]
佳木斯市	佳木斯市	Jiā mù sī shì	Kiamusze or Jiamusi prefecture-level city in Heilongjiang province 黑龍江|黑龙江[Hēi lóng jiāng] in northeast China
來賓市	来宾市	Lái bīn shì	Laibin prefecture-level city in Guangxi
侯馬市	侯马市	Hóu mǎ shì	Houma county level city in Linfen 臨汾|临汾[Lín fén], Shanxi
保定市	保定市	Bǎo dìng shì	Baoding prefecture-level city in Hebei
保山市	保山市	Bǎo shān shì	Baoshan prefecture-level city in Yunnan
信宜市	信宜市	Xìn yí shì	Xinyi county level city in Maoming 茂名, Guangdong
信陽市	信阳市	Xìn yáng Shì	Xinyang prefecture level city in Henan
個舊市	个旧市	Gè jiù shì	Gejiu, county level city in Yunnan, capital of Honghe Hani and Yi autonomous county 紅河哈尼族彞族自治州|红河哈尼族彝族自治州
偃師市	偃师市	Yǎn shī shì	Yanshi county level city in Luoyang 洛陽|洛阳, Henan
做市商	做市商	zuò shì shāng	market maker
偶語棄市	偶语弃市	ǒu yǔ qì shì	chance remarks can lead to public execution (idiom)
儀征市	仪征市	Yí zhēng shì	Yizheng county level city in Yangzhou 揚州|扬州[Yáng zhōu], Jiangsu
儋州市	儋州市	Dān zhōu shì	Danzhou city, Hainan
元山市	元山市	Yuán shān shì	Wonsan city in Kangweon province 江原道 of North Korea
元朗市	元朗市	Yuán Lǎng shì	Yuen Long town, Hong Kong Island
光州市	光州市	Guāng zhōu shì	Guangzhou, old name for Huangchuan 潢川[Huáng chuān] in Xinyang 信陽|信阳, Henan/Gwangju Metropolitan City, capital of South Jeolla Province 全羅南道|全罗南道[Quán luó nán dào], South Korea
光州廣域市	光州广域市	Guāng zhōu guǎng yù shì	Gwangju Metropolitan City, capital of South Jeolla Province 全羅南道|全罗南道[Quán luó nán dào], South Korea
克拉瑪依市	克拉玛依市	Kè lā mǎ yī shì	Qaramay shehiri (Karamay city) or Kèlāmǎyī prefecture-level city in Xinjiang
兗州市	兖州市	Yǎn zhōu Shì	Yanzhou county level city in Jining 濟寧|济宁[Jǐ níng], Shandong
內江市	内江市	Nèi jiāng shì	Neijiang prefecture level city in Sichuan
全州市	全州市	Quán zhōu shì	Jeonju city, capital of North Jeolla Province, in west South Korea
全市	全市	quán shì	whole city
八德市	八德市	Bā dé shì	Bade or Pate city in Taoyuan county 桃園縣|桃园县[Táo yuán xiàn], north Taiwan
公主嶺市	公主岭市	Gōng zhǔ lǐng shì	Gongzhuling county level city in Siping 四平, Jilin
六安市	六安市	Lù ān shì	Lu'an prefecture-level city in Anhui
六盤水市	六盘水市	Liù pán shuǐ shì	Liupanshui prefecture-level city in Guizhou 貴州|贵州[Guì zhōu]
冀州市	冀州市	Jì zhōu shì	Jishou county level city in Hengshui 衡水[Héng shuǐ], Hebei
冷水江市	冷水江市	Lěng shuǐ jiāng shì	Lengshuijiang county level city in Loudi 婁底|娄底[Lóu dǐ], Hunan
凌海市	凌海市	Líng hǎi shì	Linghai county level city in Jinzhou 錦州|锦州, Liaoning
凌源市	凌源市	Líng yuán shì	Lingyuan county level city in Chaoyang 朝陽|朝阳[Cháo yáng], Liaoning
凱里市	凯里市	Kǎi lǐ shì	Kaili city in Guizhou, capital of Qiandongnan Miao and Dong autonomous prefecture 黔東南苗族侗族自治州|黔东南苗族侗族自治州
利川市	利川市	Lì chuān shì	Lichuan county level city in Enshi Tujia and Miao autonomous prefecture 恩施土家族苗族自治州[Ēn shī Tǔ jiā zú Miáo zú zì zhì zhōu], Hubei
利市	利市	lì shì	business profit/auspicious/lucky/small sum of money offered on festive days
副地級市	副地级市	fù dì jí shì	sub-prefecture-level city (county level division, administered by province, not under a prefecture)
副市長	副市长	fù shì zhǎng	deputy mayor
副省級城市	副省级城市	fù shěng jí chéng shì	subprovincial city (having independent economic status within a province)
創業板上市	创业板上市	chuàng yè bǎn shàng shì	Growth Enterprise Markets (GEM)
勞務市場	劳务市场	láo wù shì chǎng	labor market
包頭市	包头市	Bāo tóu shì	Baotou prefecture-level city in Inner Mongolia
化州市	化州市	Huà zhōu shì	Huazhou county level city in Maoming 茂名, Guangdong
北京市	北京市	Běi jīng Shì	Beijing/capital of People's Republic of China/one of the four municipalities 直轄市|直辖市[zhí xiá shì]
北安市	北安市	Běi ān shì	Bei'an county level city in Heihe 黑河[Hēi hé], Heilongjiang
北屯市	北屯市	Běi tún shì	Beitun city or town in Altay prefecture 阿勒泰地區|阿勒泰地区[Ā lè tài dì qū], Xinjiang
北流市	北流市	Běi liú shì	Beiliu county level city in Yulin 玉林[Yù lín], Guangxi
北海市	北海市	Běi hǎi shì	Beihai prefecture-level city and seaport in Guangxi
北票市	北票市	Běi piào shì	Beipiao county level city in Chaoyang 朝陽|朝阳[Cháo yáng], Liaoning
北鎮市	北镇市	Běi zhèn shì	Beizhen county level city in Jinzhou 錦州|锦州, Liaoning
十堰市	十堰市	Shí yàn shì	Shiyan prefecture level city in Hubei
升市	升市	shēng shì	rising prices/bull market
南京市	南京市	Nán jīng shì	Nanjing subprovincial city on the Changjiang, capital of Jiangsu province 江蘇|江苏/capital of China at different historical periods
南充市	南充市	Nán chōng shì	Nanchong prefecture level city in Sichuan
南安市	南安市	Nán ān shì	Nan'an county level city in Quanzhou 泉州[Quán zhōu], Fujian
南宮市	南宫市	Nán gōng shì	Nangong county level city in Xingtai 邢台[Xíng tái], Hebei
南寧市	南宁市	Nán níng Shì	Nanning prefecture level city and capital of Guangxi Zhuang autonomous region 廣西壯族自治區|广西壮族自治区[Guǎng xī Zhuàng zú Zì zhì qū] in south China
南市區	南市区	Nán shì Qū	Nanshi District, former district of Shanghai, merged into Huangpu District 黃浦區|黄浦区[Huáng pǔ qū] in 2000
南平市	南平市	Nán píng shì	Nanping prefecture level city in Fujian
南康市	南康市	Nán kāng shì	Nankang county level city in Ganzhou 贛州|赣州, Jiangxi
南投市	南投市	Nán tóu shì	Nantou city in central Taiwan, capital of Nantou county
南昌市	南昌市	Nán chāng shì	Nanchang prefecture level city and capital of Jiangxi province 江西省 in southeast China
南浦市	南浦市	Nán pǔ shì	Nampo city in North Korea
南通市	南通市	Nán tōng shì	Nantong prefecture level city in Jiangsu
南陽市	南阳市	Nán yáng shì	Nanyang prefecture level city in Henan
南雄市	南雄市	Nán xióng Shì	Nanxiong county level city in Shaoguan 韶關|韶关[Sháo guān], Guangdong
博樂市	博乐市	Bó lè shì	Börtala Shehiri of Bole City, county level city in Börtala Mongol autonomous prefecture 博爾塔拉蒙古自治州|博尔塔拉蒙古自治州, Xinjiang
即墨市	即墨市	Jí mò Shì	Jimo county level city in Qingdao 青島|青岛[Qīng dǎo], Shandong
原平市	原平市	Yuán píng shì	Yuanping county level city in Xinzhou 忻州[Xīn zhōu], Shanxi
古交市	古交市	Gǔ jiāo shì	Gujiao county level city in Taiyuan 太原[Tài yuán], Shanxi
句容市	句容市	Jù róng shì	Jurong county level city in Zhenjiang 鎮江|镇江[Zhèn jiāng], Jiangsu
台北市	台北市	Tái běi shì	Taibei or Taipei, capital of Taiwan
台山市	台山市	Tái shān shì	Taishan county level city in Jiangmen 江門|江门, Guangdong
台州市	台州市	Tāi zhōu shì	Taizhou prefecture level city in Zhejiang
台東市	台东市	Tái dōng shì	Taitung city in southeast Taiwan, capital of Taitung county
合作市	合作市	Hé zuò shì	Hezuo county level city in Gannan Tibetan autonomous prefecture 甘南藏族自治州[Gān nán Zàng zú zì zhì zhōu], Gansu
合山市	合山市	Hé shān shì	Heshan county level city in Laibin 來賓|来宾[Lái bīn], Guangxi
合肥市	合肥市	Hé féi shì	Hefei, capital of Anhui Province 安徽省[Ān huī Shěng] in south central China
吉安市	吉安市	Jí ān shì	Ji'an prefecture-level city in Jiangxi
吉林市	吉林市	Jí lín shì	Jilin prefecture-level city in Jilin province 吉林省 in northeast China
吉首市	吉首市	Jí shǒu shì	Jishou county level city and capital of Xiangxi Tujia and Miao autonomous prefecture 湘西土家族苗族自治州[Xiāng xī Tǔ jiā zú Miáo zú zì zhì zhōu], Henan
同江市	同江市	Tóng jiāng shì	Tongjiang county level city in Kiamusze or Jiamusi city 佳木斯[Jiā mù sī], Heilongjiang
吐魯番市	吐鲁番市	Tǔ lǔ fān shì	Turpan City in Xinjiang (Chinese: Tulufan)
吳川市	吴川市	Wú chuān shì	Wuchuan county level city in Zhanjiang 湛江[Zhàn jiāng], Guangdong
吳市吹簫	吴市吹箫	Wú shì chuī xiāo	to beg while playing the xiao 箫 (mouth organ)/cf Wu Zixu 伍子胥, destitute refugee from Chu 楚, busked in Wu town c. 520 BC, then became a powerful politician
吳忠市	吴忠市	Wú zhōng shì	Wuzhong prefecture level city in Ningxia
吳江市	吴江市	Wú jiāng shì	Wujiang county level city in Suzhou 蘇州|苏州[Sū zhōu], Jiangsu
呂梁市	吕梁市	Lǚ liáng shì	Lüliang prefecture-level city in Shanxi 山西
周口市	周口市	Zhōu kǒu shì	Zhoukou prefecture level city in east Henan 河南
呼倫貝爾市	呼伦贝尔市	Hū lún bèi ěr shì	Hulunbuir prefecture-level city in Inner Mongolia
呼和浩特市	呼和浩特市	Hū hé hào tè Shì	Hohhot prefecture-level city, capital of Inner Mongolia autonomous region 內蒙古自治區|内蒙古自治区[Nèi měng gǔ Zì zhì qū]
和田市	和田市	Hé tián Shì	Hotan, a major oasis town in southwestern Xinjiang
和龍市	和龙市	Hé lóng shì	Helong county level city in Yanbian Korean autonomous prefecture 延邊朝鮮族自治州|延边朝鲜族自治州, Jilin
咸寧市	咸宁市	Xián níng shì	Xianning prefecture level city in Hubei
咸興市	咸兴市	Xián xīng Shì	Hamhung, North Korea
咸陽市	咸阳市	Xián yáng Shì	Xianyang prefecture level city in Shaanxi
哈密市	哈密市	Hā mì shì	Kumul city in Xinjiang (Chinese: Hami)
哈爾濱市	哈尔滨市	Hā ěr bīn shì	Harbin, subprovincial city and capital of Heilongjiang province 黑龍江|黑龙江[Hēi lóng jiāng] in northeast China
唐山市	唐山市	Táng shān shì	Tangshan prefecture level city in Hebei
商丘市	商丘市	Shāng qiū shì	Shangqiu prefecture level city in Henan
商洛市	商洛市	Shāng luò Shì	Shangluo prefecture level city in Shaanxi
問市	问市	wèn shì	to hit the market
啟東市	启东市	Qǐ dōng shì	Qidong county level city in Nantong 南通[Nán tōng], Jiangsu
喀什市	喀什市	Kā shí shì	Qeshqer Shehiri (Kashgar city) in the west of Xinjiang near Kyrgyzstan
嘉峪關市	嘉峪关市	Jiā yù guān shì	Jiayuguan prefecture-level city in Gansu
嘉義市	嘉义市	Jiā yì shì	Chiayi city in central Taiwan
嘉興市	嘉兴市	Jiā xīng shì	Jiaxing prefecture-level city in Zhejiang
四平市	四平市	Sì píng shì	Siping prefecture level city in Jilin province 吉林省 in northeast China
四日市	四日市	Sì rì shì	Yokkaichi, city in Mie Prefecture, Japan
四日市市	四日市市	Sì rì shì Shì	Yokkaichi, city in Mie Prefecture, Japan
四會市	四会市	Sì huì shì	Sihui county level city in Zhaoqing 肇慶|肇庆[Zhào qìng], Guangdong
固原市	固原市	Gù yuán shì	Guyuan city in Ningxia
國外市場	国外市场	guó wài shì chǎng	foreign market
圖們市	图们市	Tú mén Shì	Tumen county level city in Yanbian Korean autonomous prefecture 延邊朝鮮族自治州|延边朝鲜族自治州, Jilin
圖木舒克市	图木舒克市	Tú mù shū kè shì	Tumxuk shehiri (Tumshuq city) or Túmùshūkè subprefecture level city in west Xinjiang
土城市	土城市	Tǔ chéng shì	Tucheng city in New Taipei City 新北市[Xīn běi shì], Taiwan
地級市	地级市	dì jí shì	prefecture-level city
城市	城市	chéng shì	city/town/CL:座[zuò]
城市依賴症	城市依赖症	chéng shì yī lài zhèng	"urban dependence disease" (sufferers are unwilling to give up city comforts and return to the countryside)
城市化	城市化	chéng shì huà	urbanization
城市區域	城市区域	chéng shì qū yù	urban area/city district
城市管理行政執法局	城市管理行政执法局	Chéng shì Guǎn lǐ Xíng zhèng Zhí fǎ jú	City Urban Administrative and Law Enforcement Bureau (PRC)
城市規劃	城市规划	chéng shì guī huà	town planning
城市運動會	城市运动会	Chéng shì Yùn dòng huì	National Intercity Games, Chinese athletics competition, organized every four years since 1988
基隆市	基隆市	Jī lóng shì	Chilung or Keelung, city and major port in north Taiwan
塔城市	塔城市	Tǎ chéng shì	Tarbaghatay or Tacheng city in Tacheng prefecture 塔城地區|塔城地区[Tǎ chéng dì qū], Xinjiang
壽光市	寿光市	Shòu guāng shì	Shouguang county level city in Weifang 濰坊|潍坊[Wéi fāng], Shandong
多頭市場	多头市场	duō tóu shì cháng	bull market
夜市	夜市	yè shì	night market
大冶市	大冶市	Dà yě shì	Daye county level city in Huangshi 黃石|黄石[Huáng shí], Hubei
大同市	大同市	Dà tóng shì	Datong prefecture-level city in Shanxi 山西
大城市	大城市	dà chéng shì	major city/metropolis
大安市	大安市	Dà ān shì	Da'an county level city in Baicheng 白城, Jilin
大慶市	大庆市	Dà qìng shì	Daqing prefecture-level city in Heilongjiang province 黑龍江|黑龙江[Hēi lóng jiāng] in northeast China
大理市	大理市	Dà lǐ shì	Dali city, capital of Dali Bai autonomous prefecture 大理白族自治州 in Yunnan
大田市	大田市	Dà tián shì	Daejeon Metropolitan City, capital of South Chungcheong Province 忠清南道[Zhōng qīng nán dào], South Korea
大田廣域市	大田广域市	Dà tián guǎng yù shì	Daejeon Metropolitan City, capital of South Chungcheong Province 忠清南道[Zhōng qīng nán dào], South Korea
大石橋市	大石桥市	Dà shí qiáo shì	Great stone bridge or Dashiqiao county level city in Yingkou 營口|营口, Liaoning
大豐市	大丰市	Dà fēng shì	Dafeng county level city in Yancheng 鹽城|盐城[Yán chéng], Jiangsu
大跌市	大跌市	dà diē shì	great market fall/market crash
大連市	大连市	Dà lián shì	Dalian subprovincial city in Liaoning province 遼寧省|辽宁省 in northeast China
大邱市	大邱市	Dà qiū shì	Daegu Metropolitan City, capital of North Gyeongsang Province 慶尚北道|庆尚北道[Qìng shàng běi dào] in east South Korea
大邱廣域市	大邱广域市	Dà qiū guǎng yù shì	Daegu Metropolitan City, capital of North Gyeongsang Province 慶尚北道|庆尚北道[Qìng shàng běi dào] in east South Korea
大都市	大都市	dà dū shì	metropolis/large city/megacity
大都市地區	大都市地区	dà dū shì dì qū	metropolitan area
大里市	大里市	Dà lǐ shì	Tali or Dali city in Taichung county 臺中縣|台中县[Tái zhōng xiàn], Taiwan
天水市	天水市	Tiān shuǐ shì	Tianshui prefecture level city in Gansu
天津市	天津市	Tiān jīn shì	Tianjin, a municipality in northeast China, abbr. 津
天長市	天长市	Tiān cháng shì	Tianchang county level city in Chuzhou 滁州[Chú zhōu], Anhui
天門市	天门市	Tiān mén shì	Tianmen sub-prefecture level city in Hubei
太保市	太保市	Tài bǎo shì	Taibao or Taipao city in Chiayi county 嘉義縣|嘉义县[Jiā yì xiàn], west Taiwan
太倉市	太仓市	Tài cāng shì	Taicang county level city in Suzhou 蘇州|苏州[Sū zhōu], Jiangsu
太原市	太原市	Tài yuán shì	Taiyuan prefecture level city and capital of Shanxi province 山西省 in central north China
太平市	太平市	Tài píng shì	Taiping city in Taichung county 臺中縣|台中县[Tái zhōng xiàn], Taiwan
奉化市	奉化市	Fèng huà shì	Fenghu county level city in Ningbo 寧波|宁波[Níng bō], Zhejiang
奎屯市	奎屯市	Kuí tún shì	Kuitun city or Küytun shehiri in Ili Kazakh autonomous prefecture 伊犁哈薩克自治州|伊犁哈萨克自治州[Yī lí Hā sà kè zì zhì zhōu], Xinjiang
好市多	好市多	Hǎo shì duō	Costco (warehouse club chain)
如皋市	如皋市	Rú gāo shì	Rugao county level city in Nantong 南通[Nán tōng], Jiangsu
姫路市	姫路市	Jī lù shì	Himeji city in Hyōgo prefecture 兵庫縣|兵库县, Japan
姬路市	姬路市	Jī lù shì	Himeji city in Hyōgo prefecture 兵庫縣|兵库县, Japan
威海市	威海市	Wēi hǎi shì	Weihai prefecture level city in Shandong
婁底市	娄底市	Lóu dǐ shì	Loudi prefecture-level city in Hunan
孝感市	孝感市	Xiào gǎn shì	Xiaogan prefecture level city in Hubei
孝義市	孝义市	Xiào yì shì	Xiaoyi county level city in Lüliang 呂梁|吕梁[Lǚ liáng], Shanxi 山西
孟州市	孟州市	Mèng zhōu shì	Mengzhou county level city in Jiaozuo 焦作[Jiāo zuò], Henan
安丘市	安丘市	Ān qiū shì	Anqiu county level city in Weifang 濰坊|潍坊[Wéi fāng], Shandong
安國市	安国市	Ān guó shì	Anguo county level city in Baoding 保定[Bǎo dìng], Hebei
安寧市	安宁市	Ān níng shì	Anning county level city in Kunming 昆明[Kūn míng], Yunnan
安康市	安康市	Ān kāng Shì	Ankang prefecture-level city in Shaanxi
安慶市	安庆市	Ān qìng shì	Anqing prefecture-level city in Anhui
安達市	安达市	Ān dá shì	Anda county level city in Suihua 綏化|绥化, Heilongjiang
安陸市	安陆市	Ān lù shì	Anlu county level city in Xiaogan 孝感[Xiào gǎn], Hubei
安陽市	安阳市	Ān yáng shì	Anyang prefecture-level city in Henan
安順市	安顺市	Ān shùn shì	Anshun prefecture-level city in Guizhou 貴州|贵州[Guì zhōu]
定州市	定州市	Dìng zhōu shì	Dingzhou county level city in Baoding 保定[Bǎo dìng], Hebei
定西市	定西市	Dìng xī shì	Dingxi prefecture-level city in Gansu
宜城市	宜城市	Yí chéng shì	Yicheng county level city in Xiangfan 襄樊[Xiāng fán], Hubei
宜州市	宜州市	Yí zhōu shì	Yizhou county level city in Hechi 河池[Hé chí], Guangxi
宜昌市	宜昌市	Yí chāng shì	Yichang prefecture level city in Hubei
宜春市	宜春市	Yí chūn shì	Yichun prefecture level city in Jiangxi
宜興市	宜兴市	Yí xīng shì	Yixing county level city in Wuxi 無錫|无锡[Wú xī], Jiangsu
宜蘭市	宜兰市	Yí lán shì	Yilan city in Yilan county 宜蘭縣|宜兰县[Yí lán xiàn], northeast Taiwan
宜賓市	宜宾市	Yí bīn shì	Yibin prefecture level city in Sichuan
宜都市	宜都市	Yí dū shì	Yidu county level city in Yichang 宜昌[Yí chāng], Hubei
宣城市	宣城市	Xuān chéng shì	Xuancheng prefecture level city in Anhui
宣威市	宣威市	Xuān wēi shì	Xuanwei county level city in Qujing 曲靖[Qǔ jìng], Yunnan
宿州市	宿州市	Sù zhōu shì	Suzhou prefecture level city in Anhui
宿遷市	宿迁市	Sù qiān shì	Suqian prefecture level city in Jiangsu
密山市	密山市	Mì shān shì	Mishan county level city in Jixi 雞西|鸡西[Jī xī], Heilongjiang
富錦市	富锦市	Fù jǐn shì	Fujin county level city in Kiamusze or Jiamusi city 佳木斯[Jiā mù sī], Heilongjiang
富陽市	富阳市	Fù yáng shì	Fuyang county level city in Hangzhou 杭州[Háng zhōu], Zhejiang
寧國市	宁国市	Níng guó shì	Ningguo county level city in Xuancheng 宣城[Xuān chéng], Anhui
寧安市	宁安市	Níng ān shì	Ning'an county level city in Mudanjiang 牡丹江, Heilongjiang
寧德市	宁德市	Níng dé shì	Ningde prefecture level city in Fujian
寧波市	宁波市	Níng bō shì	Ningbo subprovincial city in Zhejiang
寶雞市	宝鸡市	Bǎo jī Shì	Baoji prefecture-level city in Shaanxi/called Chencang 陳倉|陈仓[Chén cāng] in ancient times
尚志市	尚志市	Shàng zhì shì	Shangzhi county level city in Harbin 哈爾濱|哈尔滨[Hā ěr bīn], Heilongjiang
屏東市	屏东市	Píng dōng Shì	Pingtung City in south Taiwan
山谷市	山谷市	Shān gǔ Shì	the Valley, capital of Anguilla
岑溪市	岑溪市	Cén xī shì	Cenxi county level city in Wuzhou 梧州[Wú zhōu], Guangxi
岳陽市	岳阳市	Yuè yáng shì	Yueyang prefecture level city in Hunan
峨嵋山市	峨嵋山市	É méi shān shì	Emeishan city in Sichuan
峨眉山市	峨眉山市	É méi shān shì	Emeishan county level city in Leshan 樂山|乐山[Lè shān], Sichuan
崇州市	崇州市	Chóng zhōu shì	Chongzhou county level city in Chengdu 成都[Chéng dū], Sichuan
崇左市	崇左市	Chóng zuǒ shì	Chongzuo prefecture-level city in Guangxi
崑山市	昆山市	Kūn shān shì	Kunshan county level city in Suzhou 蘇州|苏州[Sū zhōu], Jiangsu
嵊州市	嵊州市	Shèng zhōu shì	Shengzhou county level city in Shaoxing 紹興|绍兴[Shào xīng], Zhejiang
巢湖市	巢湖市	Cháo hú shì	Chaohu prefecture-level city in Anhui
巴中市	巴中市	Bā zhōng shì	Bazhong prefecture-level city in Panzhihua 攀枝花[Pān zhī huā], south Sichuan
巴彥浩特市	巴彦浩特市	Bā yàn Hào tè Shì	Bayan Hot, capital of Alxa League 阿拉善盟[Ā lā shàn Méng], Inner Mongolia/also written 巴彥浩特鎮|巴彦浩特镇[Bā yàn Hào tè Zhèn]
巴彥淖爾市	巴彦淖尔市	Bā yàn nào ěr shì	Bayan Nur prefecture-level city in Inner Mongolia
七台河市	七台河市	Qī tái hé shì	Qitaihe prefecture level city, Heilongjiang province
市丈	市丈	shì zhàng	zhang (Chinese unit of length equal to 3⅓ meters)
市中區	市中区	shì zhōng qū	central city district
市中心	市中心	shì zhōng xīn	city center/downtown
市井	市井	shì jǐng	marketplace/town/the street (urban milieu)/the haunts of the common people
市井小民	市井小民	shì jǐng xiǎo mín	ordinary people/the hoi polloi/commoner
市佔率	市占率	shì zhàn lǜ	market share/abbr. for 市場佔有率|市场占有率
市值	市值	shì zhí	market capitalization/market value
市價	市价	shì jià	market value
市儈	市侩	shì kuài	unscrupulous businessperson/profiteer/philistine
市內	市内	shì nèi	inside the city
市兩	市两	shì liǎng	Chinese unit of weight equivalent to 50 grams
市分	市分	shì fēn	fen (Chinese unit of length equal to ⅓ centimeter)
市制	市制	shì zhì	Chinese units of measurement
市北區	市北区	Shì běi qū	Shibei district of Qingdao city 青島市|青岛市, Shandong
市區	市区	shì qū	urban district/downtown/city center
市南區	市南区	Shì nán qū	Shinan district of Qingdao city 青島市|青岛市, Shandong
市厘	市厘	shì lí	li (Chinese unit of length equal to ⅓ millimeter)
市場	市场	shì chǎng	marketplace/market (also in abstract)
市場份額	市场份额	shì chǎng fèn é	market share
市場佔有率	市场占有率	shì chǎng zhàn yǒu lǜ	market share
市場價	市场价	shì chǎng jià	market price
市場准入	市场准入	shì chǎng zhǔn rù	access to markets
市場劃分	市场划分	shì chǎng huà fēn	market segmentation
市場化	市场化	shì chǎng huà	marketization
市場定位	市场定位	shì chǎng dìng wèi	positioning (marketing)
市場換技術	市场换技术	shì chǎng huàn jì shù	market access in return for technology transfer (PRC policy since the 1980s which gives foreign companies access to China's domestic market in exchange for sharing their intellectual property, characterized by the US in the 2019 trade war as "forced technology transfer")
市場營銷	市场营销	shì chǎng yíng xiāo	marketing
市場競爭	市场竞争	shì chǎng jìng zhēng	market competition
市場經濟	市场经济	shì chǎng jīng jì	market economy
市場調查	市场调查	shì chǎng diào chá	market research
市委	市委	shì wěi	municipal committee
市容	市容	shì róng	appearance of a city
市寸	市寸	shì cùn	cun (Chinese unit of length equal to ⅓ decimeter)
市尺	市尺	shì chǐ	chi (Chinese unit of length equal to ⅓ meter)
市引	市引	shì yǐn	unit of distance equal to one-thirtieth km or 33.33 meters
市撮	市撮	shì cuō	milliliter (old)
市擔	市担	shì dàn	Chinese unit of weight equal to 100 jin (or 50 kg)
市政	市政	shì zhèng	municipal administration
市政府	市政府	shì zhèng fǔ	city hall/city government
市政廳	市政厅	shì zhèng tīng	city hall
市政稅	市政税	shì zhèng shuì	city council rates/municipal taxes
市斤	市斤	shì jīn	Chinese unit of weight equal to 0.5 kg
市曹	市曹	shì cáo	market/official in charge of small merchants
市民	市民	shì mín	city resident
市民社會	市民社会	shì mín shè huì	civil society (law)
市淨率	市净率	shì jìng lǜ	price-to-book ratio (finance)
市盈率	市盈率	shì yíng lǜ	PE ratio
市立	市立	shì lì	municipal/city/city-run
市縣	市县	shì xiàn	towns and counties
市議員	市议员	shì yì yuán	town councilor/city councilor/alderman
市議會	市议会	shì yì huì	city council
市轄區	市辖区	shì xiá qū	city district (county-level administrative unit)
市郊	市郊	shì jiāo	outer city/suburb
市里	市里	shì lǐ	li (Chinese unit of length equal to 500 meters)
市錢	市钱	shì qián	Chinese unit of weight equivalent to 5 grams
市鎮	市镇	shì zhèn	small town
市長	市长	shì zhǎng	mayor
市集	市集	shì jí	fair/market (in a public place)/small town
市面	市面	shì miàn	the marketplace (i.e. the world of business and commerce)
市面上	市面上	shì miàn shàng	on the market
市頃	市顷	shì qǐng	unit of area equal to 100 畝|亩[mǔ] or 6.67 hectares
布拉薩市	布拉萨市	Bù lā sà shì	Brazzaville, capital of Congo (Tw)
常寧市	常宁市	Cháng níng shì	Changning county level city in Hengyang 衡陽|衡阳[Héng yáng], Hunan
常州市	常州市	Cháng zhōu shì	Changzhou prefecture-level city in Jiangsu
常德市	常德市	Cháng dé shì	Changde prefecture-level city in Hunan
常熟市	常熟市	Cháng shú Shì	Changshu county level city in Suzhou 蘇州|苏州[Sū zhōu], Jiangsu
平壤市	平壤市	Píng rǎng shì	Pyongyang, capital of North Korea
平度市	平度市	Píng dù Shì	Pingdu county level city in Qingdao 青島|青岛[Qīng dǎo], Shandong
平涼市	平凉市	Píng liáng shì	Pingliang prefecture level city in Gansu
平湖市	平湖市	Píng hú shì	Pinghu county level city in Jiaxing 嘉興|嘉兴[Jiā xīng], Zhejiang
平鎮市	平镇市	Píng zhèn shì	Pingzhen or Pingchen city in Taoyuan county 桃園縣|桃园县[Táo yuán xiàn], north Taiwan
平頂山市	平顶山市	Píng dǐng shān shì	Pingdingshan prefecture level city in Henan
座頭市	座头市	Zuò tóu Shì	Zatoichi
庫爾勒市	库尔勒市	Kù ěr lè shì	Korla Shehiri, Korla or Ku'erle City, capital of Bayingolin Mongol Autonomous Prefecture, Xinjiang 巴音郭楞蒙古自治州[Bā yīn guō léng Měng gǔ Zì zhì zhōu]
廈門市	厦门市	Xià mén shì	Xiamen, subprovincial city in Fujian/also known as Amoy
廉江市	廉江市	Lián jiāng shì	Lianjiang county level city in Zhanjiang 湛江[Zhàn jiāng], Guangdong
廊坊市	廊坊市	Láng fáng shì	Langfang prefecture-level city in Hebei
廣元市	广元市	Guǎng yuán shì	Guangyuan prefecture-level city in Sichuan
廣域市	广域市	guǎng yù shì	metropolitan city, South Korean analog of PRC municipality 直轄市|直辖市[zhí xiá shì]
廣安市	广安市	Guǎng ān shì	Guang'an prefecture-level city in Sichuan
廣州市	广州市	Guǎng zhōu shì	Guangzhou subprovincial city and capital of Guangdong/Canton
廣水市	广水市	Guǎng shuǐ shì	Guangshui county level city in Suizhou 隨州|随州[Suí zhōu], Hubei
廣漢市	广汉市	Guǎng hàn shì	Guanghan county level city in Deyang 德陽|德阳[Dé yáng], Sichuan
延吉市	延吉市	Yán jí shì	Yanji county level city, capital of Yanbian Korean autonomous prefecture 延邊朝鮮族自治州|延边朝鲜族自治州, Jilin
延安市	延安市	Yán ān shì	Yán'ān prefecture level city in Shaanxi 陝西|陕西, communist headquarters during the war
建德市	建德市	Jiàn dé shì	Jiande county level city in Hangzhou 杭州[Háng zhōu], Zhejiang
建甌市	建瓯市	Jiàn ōu shì	Jian'ou county level city in Nanping 南平[Nán píng] Fujian
建陽市	建阳市	Jiàn yáng shì	Jianyang county level city in Nanping 南平[Nán píng] Fujian
張家口市	张家口市	Zhāng jiā kǒu shì	Zhangjiakou prefecture level city in Hebei
張家港市	张家港市	Zhāng jiā gǎng shì	Zhangjiagang county level city in Suzhou 蘇州|苏州[Sū zhōu], Jiangsu
張家界市	张家界市	Zhāng jiā jiè shì	Zhangjiajie prefecture level city in Hunan
張掖市	张掖市	Zhāng yè shì	Zhangye prefecture level city in Gansu
彭州市	彭州市	Péng zhōu shì	Pengzhou county level city in Chengdu 成都[Chéng dū], Sichuan
彰化市	彰化市	Zhāng huà shì	Zhanghua or Changhua city in west Taiwan, capital of Changhua county
徐州市	徐州市	Xú zhōu shì	Xuzhou prefecture level city in Jiangsu
從化市	从化市	Cóng huà shì	Conghua county level city in Guangzhou 廣州|广州[Guǎng zhōu], Guangdong
德令哈市	德令哈市	Dé lìng hā shì	Delingha city in Haixi Mongol and Tibetan autonomous prefecture 海西蒙古族藏族自治州[Hǎi xī Měng gǔ zú Zàng zú zì zhì zhōu], Qinghai
德州市	德州市	Dé zhōu shì	Dezhou prefecture-level city in Shandong
德惠市	德惠市	Dé huì shì	Dehui county level city in Changchun 長春|长春, Jilin
德興市	德兴市	Dé xīng shì	Dexing county level city in Shangrao 上饒|上饶, Jiangxi
德陽市	德阳市	Dé yáng shì	Deyang prefecture-level city in Sichuan
忻州市	忻州市	Xīn zhōu shì	Xinzhou prefecture level city in Shanxi 山西
思茅市	思茅市	Sī máo shì	Simao city in Yunnan, renamed Pu'er city 普洱市 in 2007
怡保市	怡保市	Yí bǎo shì	Ipoh city in Malaysia, capital of Sultanate of Perak on Malayan peninsula
恩平市	恩平市	Ēn píng shì	Enping county level city in Jiangmen 江門|江门, Guangdong
恩施市	恩施市	Ēn shī shì	Enshi prefecture-level city in Hubei, capital of Enshi Tujia and Miao autonomous prefecture 恩施土家族苗族自治州
惠州市	惠州市	Huì zhōu shì	Huizhou prefecture-level city in Guangdong province
慈溪市	慈溪市	Cí xī shì	Cixi county level city in Ningbo 寧波|宁波[Níng bō], Zhejiang
慢城市	慢城市	màn chéng shì	slow-paced town
慶陽市	庆阳市	Qìng yáng shì	Qingyang prefecture level city in Gansu
憑祥市	凭祥市	Píng xiáng shì	Pingxiang county level city in Chongzuo 崇左[Chóng zuǒ], Guangxi
應城市	应城市	Yīng chéng shì	Yingcheng county level city in Xiaogan 孝感[Xiào gǎn], Hubei
應市	应市	yìng shì	to respond to the market/to buy or sell according to market conditions
懷化市	怀化市	Huái huà shì	Huaihua prefecture-level city in Hunan
成都市	成都市	Chéng dū shì	Chengdu subprovincial city and capital of Sichuan province 四川 in southwest China
房市	房市	fáng shì	real estate market
扎蘭屯市	扎兰屯市	Zhā lán tún shì	Zhalantun county level city, Mongolian Zalan-ail xot, in Hulunbuir 呼倫貝爾|呼伦贝尔[Hū lún bèi ěr], Inner Mongolia
承德市	承德市	Chéng dé shì	Chengde prefecture-level city in Hebei
投放市場	投放市场	tóu fàng shì chǎng	to put sth on the market
拉薩市	拉萨市	Lā sà Shì	Lhasa, Tibetan: Lha sa grong khyer, capital of Tibet autonomous region 西藏自治區|西藏自治区[Xī zàng Zì zhì qū]
招搖過市	招摇过市	zhāo yáo guò shì	to parade oneself ostentatiously about town (idiom)
招遠市	招远市	Zhāo yuǎn shì	Zhaoyuan county level city in Yantai 煙台|烟台, Shandong
提爾市	提尔市	Tí ěr Shì	Tyre (Lebanon)
揚中市	扬中市	Yáng zhōng shì	Yangzhong county level city in Zhenjiang 鎮江|镇江[Zhèn jiāng], Jiangsu
揚州市	扬州市	Yáng zhōu shì	Yangzhou prefecture level city in Jiangsu
揭陽市	揭阳市	Jiē yáng shì	Jieyang prefecture-level city in Guangdong province
撫州市	抚州市	Fǔ zhōu shì	Fuzhou prefecture-level city in Jiangxi
撫順市	抚顺市	Fǔ shùn shì	Fushun prefecture-level city in Liaoning province 遼寧省|辽宁省 in northeast China
攀枝花市	攀枝花市	Pān zhī huā shì	Panzhihua prefecture level city in south Sichuan, bordering Yunnan, famous for steel production and pollution
救市	救市	jiù shì	market rescue (by central bank)
敦化市	敦化市	Dūn huà shì	Dunhua county level city in Yanbian Korean autonomous prefecture 延邊朝鮮族自治州|延边朝鲜族自治州, Jilin
敦煌市	敦煌市	Dūn huáng shì	Dunhuang county level city in Jiuquan 酒泉, Gansu
文昌市	文昌市	Wén chāng shì	Wenchang City, Hainan
文登市	文登市	Wén dēng shì	Wendeng county level city in Weihai 威海, Shandong
斗六市	斗六市	Dǒu liù shì	Douliu or Touliu city in Yunlin county 雲林縣|云林县[Yún lín xiàn], Taiwan
新化市	新化市	Xīn huà shì	Xinhua city in Hunan
新北市	新北市	Xīn běi shì	New Taipei City, administrative district in north Taiwan, formerly 臺北縣|台北县[Tái běi xiàn]
新密市	新密市	Xīn mì shì	Xinmi county level city in Zhengzhou 鄭州|郑州[Zhèng zhōu], Henan
新市	新市	Xīn shì	Hsinshih township in Tainan county 台南縣|台南县[Tái nán xiàn], Taiwan
新市區	新市区	Xīn shì Qū	Xinshi District of Ürümqi, Xinjiang/Sinshih District of Tainan, Taiwan
新市鄉	新市乡	Xīn shì xiāng	Hsinshih township in Tainan county 台南縣|台南县[Tái nán xiàn], Taiwan
新市鎮	新市镇	xīn shì zhèn	new town/planned community
新店市	新店市	Xīn diàn shì	Xindian or Hsintien city in New Taipei City 新北市[Xīn běi shì], Taiwan
新會市	新会市	Xīn huì shì	Xinhui city in Guangdong
新樂市	新乐市	Xīn lè shì	Xinle county level city in Shijiazhuang 石家莊|石家庄[Shí jiā zhuāng], Hebei
新民市	新民市	Xīn mín shì	Xinmin county level city in Shenyang 瀋陽|沈阳, Liaoning
新沂市	新沂市	Xīn yí shì	Xinyi city in Xuzhou 徐州[Xú zhōu], Jiangsu
新泰市	新泰市	Xīn tài shì	Xintai county level city in Tai'an 泰安[Tài ān], Shandong
新營市	新营市	Xīn yíng shì	Hsinying city in Tainan county 台南縣|台南县[Tái nán xiàn], Taiwan
新竹市	新竹市	Xīn zhú shì	Hsinchu, city in north Taiwan noted for its high tech industries
新義州市	新义州市	Xīn yì zhōu shì	Shin'ŭiju, capital of North Pyong'an Province, North Korea
新莊市	新庄市	Xīn zhuāng shì	Xinzhuang or Hsinchuang city in New Taipei City 新北市[Xīn běi shì], Taiwan
新西伯利亞市	新西伯利亚市	Xīn xī bó lì yà shì	Novosibirsk, city in Russia
新鄉市	新乡市	Xīn xiāng shì	Xinxiang prefecture level city in Henan
新鄭市	新郑市	Xīn zhèng shì	Xinzheng county level city in Zhengzhou 鄭州|郑州[Zhèng zhōu], Henan
新餘市	新余市	Xīn yú shì	Xinyu prefecture level city in Jiangxi
旅大市	旅大市	Lǚ Dà shì	former name of Dalian city 大連|大连[Dà lián] incorporating Lüshun 旅順|旅顺[Lǚ shùn]
旅遊城市	旅游城市	lǚ yóu chéng shì	tourist city
日喀則市	日喀则市	Rì kā zé shì	Shigatse or Xigaze, Tibetan: Gzhis ka rtse, city and prefecture in central Tibet, Chinese Rikaze
日照市	日照市	Rì zhào shì	Rizhao prefecture level city in Shandong
早市	早市	zǎo shì	morning market
昆明市	昆明市	Kūn míng shì	Kunming, prefecture-level city and capital of Yunnan province in southwest China
昌原市	昌原市	Chāng yuán shì	Changwon City, capital of South Gyeongsang Province 慶尚南道|庆尚南道[Qìng shàng nán dào], South Korea
昌吉市	昌吉市	Chāng jí shì	Changji county level city in Changji Hui autonomous prefecture 昌吉回族自治州[Chāng jí Huí zú zì zhì zhōu], Xinjiang
昌邑市	昌邑市	Chāng yì shì	Changyi county level city in Weifang 濰坊|潍坊[Wéi fāng], Shandong
明光市	明光市	Míng guāng shì	Mingguang county level city in Chuzhou 滁州[Chú zhōu], Anhui
明古魯市	明古鲁市	Míng gǔ lǔ shì	Bengkulu (Indonesian town on the south coast of Sumatra)
春川市	春川市	Chūn chuān shì	Chuncheon city, capital of Gangwon province 江原道[Jiāng yuán dào], South Korea
昭通市	昭通市	Zhāo tōng shì	Zhaotong prefecture level city in Yunnan
晉中市	晋中市	Jìn zhōng shì	Jinzhong prefecture-level city in Shanxi 山西
晉城市	晋城市	Jìn chéng shì	Jincheng prefecture-level city in Shanxi 山西
晉州市	晋州市	Jìn zhōu Shì	Jinzhou county-level city in Hebei, administered by the provincial capital, Shijiazhuang 石家莊市|石家庄市[Shí jiā zhuāng Shì]
晉江市	晋江市	Jìn jiāng shì	Jinjiang county level city in Quanzhou 泉州[Quán zhōu], Fujian
普寧市	普宁市	Pǔ níng shì	Puning county level city in Jieyang 揭陽|揭阳, Guangdong
普洱市	普洱市	Pǔ ěr shì	Pu'er prefecture level city in Yunnan/county capital of Ning'er Hani and Yi autonomous county 寧洱哈尼族彞族自治縣|宁洱哈尼族彝族自治县
普蘭店市	普兰店市	Pǔ lán diàn shì	Pulandian county level city in Dalian 大連|大连[Dà lián], Liaoning
景德鎮市	景德镇市	Jǐng dé zhèn shì	Jingdezhen prefecture-level city in Jiangxi province 江西, famous for porcelain
景洪市	景洪市	Jǐng hóng shì	Jinghong county level city in Xishuangbanna Dai autonomous prefecture 西雙版納傣族自治州|西双版纳傣族自治州[Xī shuāng bǎn nà Dǎi zú zì zhì zhōu], Yunnan
曲阜市	曲阜市	Qū fù Shì	Qufu county level city in Jining 濟寧|济宁[Jǐ níng], Shandong/hometown of Confucius 孔子[Kǒng zǐ]
曲靖市	曲靖市	Qǔ jìng shì	Qujing prefecture level city in Yunnan
朔州市	朔州市	Shuò zhōu shì	Shuozhou prefecture level city in Shanxi 山西
朝陽市	朝阳市	Cháo yáng shì	Chaoyang prefecture-level city in Liaoning province 遼寧省|辽宁省 in northeast China
本市	本市	běn shì	this city/our city
本溪市	本溪市	Běn xī shì	Benxi prefecture-level city in Liaoning province 遼寧省|辽宁省 in northeast China
本那比市	本那比市	Běn nà bǐ shì	Burnaby, British Columbia, Canada
朴子市	朴子市	Pú zǐ Shì	Puzi or Putzu City in Chiayi County 嘉義縣|嘉义县[Jiā yì xiàn], west Taiwan
村山富市	村山富市	Cūn shān Fù shì	Tomiichi Murayama (1924-), former prime minister of Japan
杭州市	杭州市	Háng zhōu shì	Hangzhou subprovincial city and capital of Zhejiang province in southeast China
東台市	东台市	Dōng tái shì	Dongtai county level city in Yancheng 鹽城|盐城[Yán chéng], Jiangsu
東方市	东方市	Dōng fāng shì	Dongfang City, Hainan
東港市	东港市	Dōng gǎng shì	Donggang county level city in Dandong 丹東|丹东[Dān dōng], Liaoning
東營市	东营市	Dōng yíng shì	Dongying prefecture-level city in Shandong
東興市	东兴市	Dōng xīng shì	Dongxing county level city in Fangchenggang 防城港[Fáng chéng gǎng], Guangxi
東莞市	东莞市	Dōng guǎn shì	Dongguan prefecture-level city in Guangdong 廣東省|广东省[Guǎng dōng shěng]
東陽市	东阳市	Dōng yáng shì	Dongyang county level city in Jinhua 金華|金华[Jīn huá], Zhejiang
松原市	松原市	Sōng yuán shì	Songyuan prefecture level city in Jilin province 吉林省 in northeast China
板橋市	板桥市	Bǎn qiáo shì	Banqiao or Panchiao city in New Taipei City 新北市[Xīn běi shì], Taiwan
林州市	林州市	Lín zhōu shì	Linzhou county level city in Anyang 安陽|安阳[Ān yáng], Henan
枝江市	枝江市	Zhī jiāng shì	Zhijiang county level city in Yichang 宜昌[Yí chāng], Hubei
柏崎市	柏崎市	Bǎi qí shì	Kashiwazaki city, Japan
柳州市	柳州市	Liǔ zhōu shì	Liuzhou prefecture-level city in Guangxi
株洲市	株洲市	Zhū zhōu shì	Zhuzhou prefecture level city, on the Xiangjiang river in Hunan
根河市	根河市	Gēn hé shì	Genhe county level city, Mongolian Gegeen-gol xot, in Hulunbuir 呼倫貝爾|呼伦贝尔[Hū lún bèi ěr], Inner Mongolia
格爾木市	格尔木市	Gé ěr mù shì	Golmud or Ge'ermu city (Tibetan: na gor mo grong khyer) in Haixi Mongol and Tibetan autonomous prefecture 海西蒙古族藏族自治州[Hǎi xī Měng gǔ zú Zàng zú zì zhì zhōu], Qinghai
桂平市	桂平市	Guì píng shì	Guiping county level city in Guigang 貴港|贵港[Guì gǎng], Guangxi
桂林市	桂林市	Guì lín shì	Guilin prefecture-level city in Guangxi
桃園市	桃园市	Táo yuán shì	Taoyuan city in north Taiwan, capital of Taoyuan county
桐城市	桐城市	Tóng chéng shì	Tongcheng county level city in Anqing 安慶|安庆[Ān qìng], Anhui
桐鄉市	桐乡市	Tóng xiāng shì	Tongxiang county level city in Jiaxing 嘉興|嘉兴[Jiā xīng], Zhejiang
梁山市	梁山市	Liáng shān shì	Liangshan city in Shandong
梅州市	梅州市	Méi zhōu shì	Meizhou prefecture level city in Guangdong province
梅河口市	梅河口市	Méi hé kǒu shì	Meihekou county level city in Tonghua 通化, Jilin
梧州市	梧州市	Wú zhōu shì	Wuzhou prefecture level city in Guangxi
棄市	弃市	qì shì	public execution (old)
棗莊市	枣庄市	Zǎo zhuāng shì	Zaozhuang prefecture level city in Shandong
棗陽市	枣阳市	Zǎo yáng shì	Zaoyang county level city in Xiangfan 襄樊[Xiāng fán], Hubei
棲霞市	栖霞市	Xī xiá shì	Xixia county level city in Yantai 煙台|烟台, Shandong
楚雄市	楚雄市	Chǔ xióng shì	Chuxiong county level city, capital of Chuxiong Yi autonomous prefecture 楚雄彞族自治州|楚雄彝族自治州[Chǔ xióng Yí zú zì zhì zhōu] in central Yunnan
榆林市	榆林市	Yú lín Shì	Yulin prefecture level city in Shaanxi
榆樹市	榆树市	Yú shù shì	Yushu county level city in Changchun 長春|长春, Jilin
榮市	荣市	Róng shì	Vinh, Vietnam
榮成市	荣成市	Róng chéng shì	Rongcheng county level city in Weihai 威海, Shandong
樂山市	乐山市	Lè shān shì	Leshan prefecture-level city in Sichuan
樂平市	乐平市	Lè píng shì	Leping county level city in Jingdezhen 景德鎮|景德镇, Jiangxi
樂昌市	乐昌市	Lè chāng Shì	Lechang county level city in Shaoguan 韶關|韶关[Sháo guān], Guangdong
樂清市	乐清市	Yuè qīng shì	Yueqing county level city in Wenzhou 溫州|温州[Wēn zhōu], Zhejiang
樂陵市	乐陵市	Lè líng shì	Leling county level city in Dezhou 德州[Dé zhōu], Shandong
樓市	楼市	lóu shì	real estate market
樟樹市	樟树市	Zhāng shù shì	Zhangshu county level city in Yichun 宜春, Jiangxi
樹林市	树林市	Shù lín shì	Shulin city in New Taipei City 新北市[Xīn běi shì], Taiwan
樺甸市	桦甸市	Huà diàn shì	Huadian county level city in Jilin prefecture 吉林, Jilin province
橫濱市	横滨市	Héng bīn shì	Yokohama, major port city in Kanagawa prefecture 神奈川縣|神奈川县[Shén nài chuān xiàn], Japan
橫須賀市	横须贺市	Héng xū hè shì	Yokosuka city and US naval base to the west of Yokohama, Japan
欽州市	钦州市	Qīn zhōu shì	Qinzhou prefecture level city in Guangxi
歐洲共同市場	欧洲共同市场	Ōu zhōu gòng tóng shì chǎng	European common market (old term for EU, European Union)
武夷山市	武夷山市	Wǔ yí shān shì	Wuyishan county level city in Nanping 南平[Nán píng] Fujian
武威市	武威市	Wǔ wēi shì	Wuwei prefecture level city in Gansu
武安市	武安市	Wǔ ān shì	Wu'an county level city in Handan 邯鄲|邯郸[Hán dān], Hebei
武岡市	武冈市	Wǔ gāng shì	Wugang county level city in Shaoyang 邵陽|邵阳[Shào yáng], Hunan
武漢市	武汉市	Wǔ hàn shì	Wuhan city on Changjiang, subprovincial city and capital of Hubei province
武穴市	武穴市	Wǔ xué shì	Wuxue county level city in Huanggang 黃岡|黄冈[Huáng gāng], Hubei
武都市	武都市	Wǔ dū shì	Wudu city in Gansu
水俁市	水俣市	Shuǐ yǔ Shì	Minamata City in Kumamoto prefecture, Japan
水原市	水原市	Shuǐ yuán shì	Suweon City, capital of Gyeonggi province 京畿道[Jīng jī dào], South Korea
水戶市	水户市	Shuǐ hù Shì	Mito City, capital of Ibaraki Prefecture, Japan
永和市	永和市	Yǒng hé shì	Yonghe or Yungho city in New Taipei City 新北市[Xīn běi shì], Taiwan
永城市	永城市	Yǒng chéng shì	Yongcheng county level city in Shangqiu 商丘[Shāng qiū], Henan
永安市	永安市	Yǒng ān shì	Yong'an county level city in Sanming 三明[Sān míng], Fujian
永州市	永州市	Yǒng zhōu shì	Yongzhou prefecture level city in Hunan
永康市	永康市	Yǒng kāng shì	Yongkang county level city in Jinhua 金華|金华[Jīn huá], Zhejiang/Yungkang city in Tainan county 台南縣|台南县[Tái nán xiàn], Taiwan
永濟市	永济市	Yǒng jì shì	Yongji county level city in Yuncheng 運城|运城[Yùn chéng], Shanxi
汐止市	汐止市	Xī zhǐ shì	Xizhi or Hsichih city in New Taipei City 新北市[Xīn běi shì], Taiwan
汕尾市	汕尾市	Shàn wěi shì	Shanwei prefecture level city in Guangdong province
汕頭市	汕头市	Shàn tóu Shì	Shantou prefecture-level city in Guangdong
汝州市	汝州市	Rǔ zhōu shì	Ruzhou county level city in Pingdingshan 平頂山|平顶山[Píng dǐng shān], Henan
江山市	江山市	Jiāng shān shì	Jiangshan county level city in Quzhou 衢州[Qú zhōu], Zhejiang
江油市	江油市	Jiāng yóu shì	Jiangyou prefecture-level city in Mianyang 綿陽|绵阳[Mián yáng], north Sichuan
江都市	江都市	Jiāng dū shì	Jiangdu county level city in Yangzhou 揚州|扬州[Yáng zhōu], Jiangsu
江門市	江门市	Jiāng mén shì	Jiangmen prefecture-level city in Guangdong
江陰市	江阴市	Jiāng yīn shì	Jiangyin county level city in Wuxi 無錫|无锡[Wú xī], Jiangsu
池州市	池州市	Chí zhōu shì	Chizhou prefecture-level city in Anhui
汨羅市	汨罗市	Mì luó shì	Miluo county-level city in Yueyang prefecture 岳陽|岳阳, Hunan
汾陽市	汾阳市	Fén yáng shì	Fenyang county level city in Lüliang 呂梁|吕梁[Lǚ liáng], Shanxi 山西
沁陽市	沁阳市	Qìn yáng shì	Qinyang county level city in Jiaozuo 焦作[Jiāo zuò], Henan
沅江市	沅江市	Yuán jiāng shì	Yuanjiang county level city in Yiyang 益陽|益阳[Yì yáng], Hunan
沙市	沙市	Shā shì	Shashi district of Jingzhou city 荊州市|荆州市[Jīng zhōu shì], Hubei
沙市區	沙市区	Shā shì qū	Shashi district of Jingzhou city 荊州市|荆州市[Jīng zhōu shì], Hubei
沙河市	沙河市	Shā hé shì	Shahe county level city in Xingtai 邢台[Xíng tái], Hebei
河池市	河池市	Hé chí shì	Hechi prefecture-level city in Guangxi/Zhuang: Hozciz
河津市	河津市	Hé jīn shì	Hejin county level city in Yuncheng 運城|运城[Yùn chéng], Shanxi
河源市	河源市	Hé yuán shì	Heyuan prefecture-level city in Guangdong 廣東省|广东省[Guǎng dōng shěng]
河間市	河间市	Hé jiān shì	Hejian county level city in Cangzhou 滄州|沧州[Cāng zhōu], Hebei
泉州市	泉州市	Quán zhōu shì	Quanzhou prefecture level city in Fujian
泊頭市	泊头市	Bó tóu shì	Botou county level city in Cangzhou 滄州|沧州[Cāng zhōu], Hebei
波特蘭市	波特兰市	Bō tè lán shì	Portland (city)
泰安市	泰安市	Tài ān shì	Tai'an prefecture level city in Shandong
泰州市	泰州市	Tài zhōu shì	Taizhou prefecture level city in Jiangsu
泰興市	泰兴市	Tài xīng shì	Taixing county level city in Taizhou 泰州[Tài zhōu], Jiangsu
洛陽市	洛阳市	Luò yáng shì	Luoyang prefecture-level city in Henan, an old capital from pre-Han times
津市	津市	Jīn shì	Jinshi county level city in Changde 常德[Cháng dé], Hunan
津市市	津市市	Jīn shì shì	Jinshi county level city in Changde 常德[Cháng dé], Hunan
洪江市	洪江市	Hóng jiāng shì	Hongjiang county level city in Huaihua 懷化|怀化[Huái huà], Hunan
洪湖市	洪湖市	Hóng hú shì	Honghu county level city in Jingzhou 荊州|荆州[Jīng zhōu], Hubei
洮南市	洮南市	Táo nán shì	Taonan county level city in Baicheng 白城, Jilin
海倫市	海伦市	Hǎi lún shì	Hailun county level city in Suihua 綏化|绥化, Heilongjiang
海口市	海口市	Hǎi kǒu Shì	Haikou prefecture-level city and capital of Hainan Province 海南省[Hǎi nán Shěng]
海城市	海城市	Hǎi chéng shì	Haicheng county level city in Anshan 鞍山[Ān shān], Liaoning
海寧市	海宁市	Hǎi níng shì	Haining county level city in Jiaxing 嘉興|嘉兴[Jiā xīng], Zhejiang
海島市	海岛市	Hǎi dǎo shì	Municipality of the Islands (Macau)/Concelho das Ilhas
海市	海市	hǎi shì	mirage (lit. or fig.)
海市蜃樓	海市蜃楼	hǎi shì shèn lóu	mirage (lit. or fig.)
海林市	海林市	Hǎi lín shì	Hailin county level city in Mudanjiang 牡丹江, Heilongjiang
海門市	海门市	Hǎi mén shì	Haimen county level city in Nantong 南通[Nán tōng], Jiangsu
海陽市	海阳市	Hǎi yáng shì	Haiyang county level city in Yantai 煙台|烟台, Shandong
涿州市	涿州市	Zhuō zhōu shì	Zhuozhou county level city in Baoding 保定[Bǎo dìng], Hebei
淄博市	淄博市	Zī bó shì	Zibo prefecture level city in Shandong
淮北市	淮北市	Huái běi shì	Huaibei prefecture-level city in Anhui
淮南市	淮南市	Huái nán shì	Huainan prefecture-level city in Anhui
淮安市	淮安市	Huái ān shì	Huai'an prefecture-level city in Jiangsu
深圳市	深圳市	Shēn zhèn shì	Shenzhen subprovincial city in Guangdong, special economic zone close to Hong Kong
深州市	深州市	Shēn zhōu shì	Shenzhou Hengshui 衡水[Héng shuǐ], Hebei
清州市	清州市	Qīng zhōu shì	Cheongju, capital of North Chungcheong Province, South Korea 忠清北道[Zhōng qīng běi dào]
清津市	清津市	Qīng jīn shì	Chongjin, capital of North Hamgyeong province 咸鏡北道|咸镜北道[Xián jìng běi dào], North Korea
清遠市	清远市	Qīng yuǎn shì	Qingyuan prefecture level city in Guangdong province
清鎮市	清镇市	Qīng zhèn shì	Qingzhen county level city in Guiyang 貴陽|贵阳[Guì yáng], Guizhou
渭南市	渭南市	Wèi nán Shì	Weinan prefecture level city in Shaanxi
港口城市	港口城市	gǎng kǒu chéng shì	port city
湖州市	湖州市	Hú zhōu shì	Huzhou prefecture-level city in Zhejiang
湘潭市	湘潭市	Xiāng tán shì	Xiangtan prefecture level city in Hunan
湘鄉市	湘乡市	Xiāng xiāng shì	Xiangxiang county level city in Xiangtan 湘潭[Xiāng tán], Hunan
湛江市	湛江市	Zhàn jiāng shì	Zhanjiang prefecture level city in Guangdong province 廣東省|广东省[Guǎng dōng shěng] in south China
溧陽市	溧阳市	Lì yáng shì	Liyang county level city in Changzhou 常州[Cháng zhōu], Jiangsu
溫嶺市	温岭市	Wēn lǐng shì	Wenling county level city in Taizhou 台州[Tāi zhōu], Zhejiang
溫州市	温州市	Wēn zhōu shì	Wenzhou prefecture level city in Zhejiang
滁州市	滁州市	Chú zhōu shì	Chuzhou prefecture-level city in Anhui
滄州市	沧州市	Cāng zhōu Shì	Cangzhou prefecture-level city in Hebei
滎陽市	荥阳市	Xíng yáng shì	Xingyang county level city in Zhengzhou 鄭州|郑州[Zhēng zhōu], Henan
滕州市	滕州市	Téng zhōu shì	Tengzhou county level city in Zaozhuang 棗莊|枣庄[Zǎo zhuāng], Shandong
滿洲里市	满洲里市	Mǎn zhōu lǐ shì	Manzhouli county level city, Mongolian Manzhuur xot, in Hulunbuir 呼倫貝爾|呼伦贝尔[Hū lún bèi ěr], Inner Mongolia
漢中市	汉中市	Hàn zhōng Shì	Hanzhong prefecture-level city in Shaanxi
漢城特別市	汉城特别市	Hàn chéng Tè bié shì	Hanseong Special Metropolitan City, old name for Seoul, capital of Korea
漢川市	汉川市	Hàn chuān shì	Hanchuan county level city in Xiaogan 孝感[Xiào gǎn], Hubei
漣源市	涟源市	Lián yuán shì	Lianyuan county level city in Loudi 婁底|娄底[Lóu dǐ], Hunan
漯河市	漯河市	Luò hé shì	Luohe prefecture-level city in Henan
漳州市	漳州市	Zhāng zhōu shì	Zhangzhou prefecture level city in Fujian
漳平市	漳平市	Zhāng píng shì	Zhangping county in Longyan 龍岩|龙岩, Fujian
潛江市	潜江市	Qián jiāng shì	Qianjiang sub-prefecture level city in Hubei
潞城市	潞城市	Lù chéng shì	Lucheng county level city in Changzhi 長治|长治[Cháng zhì], Shanxi
潞西市	潞西市	Lù xī shì	Luxi city in Yunnan, capital of Dehong Dai and Jingpo autonomous prefecture 德宏傣族景頗族自治州|德宏傣族景颇族自治州 in west Yunnan
潮州市	潮州市	Cháo zhōu shì	Chaozhou prefecture-level city in Guangdong 廣東省|广东省[Guǎng dōng shěng]
澳門市	澳门市	Ào mén shì	Municipality of Macau/Concelho de Macau
濟南市	济南市	Jǐ nán shì	Jinan subprovincial city and capital of Shandong province in northeast China
濟寧市	济宁市	Jǐ níng shì	Jining prefecture-level city in Shandong
濟源市	济源市	Jì yuán shì	Jiyuan directly administered city in Henan
濮陽市	濮阳市	Pú yáng shì	Puyang prefecture level city in Henan
濰坊市	潍坊市	Wéi fāng shì	Weifang prefecture level city in Shandong
濱州市	滨州市	Bīn zhōu shì	Binzhou prefecture-level city in Shandong
濱松市	滨松市	Bīn sōng shì	Hamamatsu, city in Shizuoka prefecture 靜岡縣|静冈县[Jìng gāng xiàn], Japan
瀋陽市	沈阳市	Shěn yáng shì	Shenyang subprovincial city and capital of Liaoning province 遼寧省|辽宁省 in northeast China/old names include Fengtian 奉天, Shengjing 盛京 and Mukden
瀏陽市	浏阳市	Liú yáng shì	Liuyang county level city in Changsha 長沙|长沙[Cháng shā], Hunan
瀘州市	泸州市	Lú zhōu shì	Luzhou prefecture-level city in Sichuan
烏海市	乌海市	Wū hǎi Shì	Wuhait or Wuhai prefecture-level city in Inner Mongolia
烏蘇市	乌苏市	Wū sū shì	Wusu city in Tacheng prefecture 塔城地區|塔城地区[Tǎ chéng dì qū], Xinjiang
烏蘭察布市	乌兰察布市	Wū lán chá bù shì	Ulaanchab prefecture level city in Inner Mongolia
烏蘭浩特市	乌兰浩特市	Wū lán hào tè shì	Wulanhaote county level city, Mongolian Ulaan xot, in Hinggan league 興安盟|兴安盟[Xīng ān méng], east Inner Mongolia
烏魯木齊市	乌鲁木齐市	Wū lǔ mù qí Shì	Ürümqi or Urumqi prefecture level city and capital of Xinjiang Uighur autonomous region 新疆維吾爾自治區|新疆维吾尔自治区[Xīn jiāng Wéi wú ěr Zì zhì qū] in west China
無錫市	无锡市	Wú xī shì	Wuxi prefecture level city in Jiangsu
焦作市	焦作市	Jiāo zuò shì	Jiaozuo prefecture-level city in Henan
煙台市	烟台市	Yān tái shì	Yantai prefecture level city in Shandong
煙花市	烟花市	yān huā shì	(old) red-light district/brothel
熊市	熊市	xióng shì	bear market
燈塔市	灯塔市	Dēng tǎ shì	Dengta county level city in Liaoyang 遼陽|辽阳[Liáo yáng], Liaoning
燒利市	烧利市	shāo lì shì	(old) to burn paper money as an offering
燕趙都市報	燕赵都市报	Yān Zhào Dū shì Bào	Yanzhao Metropolis Daily
營口市	营口市	Yíng kǒu shì	Yingkou prefecture level city in Liaoning province 遼寧省|辽宁省 in northeast China
牙克石市	牙克石市	Yá kè shí shì	Yakeshi county level city, Mongolian Yagshi xot, in Hulunbuir 呼倫貝爾|呼伦贝尔[Hū lún bèi ěr], Inner Mongolia
牛市	牛市	niú shì	bull market
牡丹江市	牡丹江市	Mǔ dan jiāng shì	Mudanjiang prefecture level city in Heilongjiang province 黑龍江|黑龙江[Hēi lóng jiāng] in northeast China
獨攬市場	独揽市场	dú lǎn shì chǎng	to monopolize a market
玉川市	玉川市	Yù chuān shì	Tamagawa city in Akita prefecture, Japan
玉林市	玉林市	Yù lín shì	Yulin prefecture level city in Guangxi
玉溪市	玉溪市	Yù xī shì	Yuxi prefecture level city in Yunnan
玉門市	玉门市	Yù mén shì	Yumen county level city in Jiuquan 酒泉, Gansu
玻璃市	玻璃市	Bō lí shì	Perlis, state of Malaysia adjacent to Thailand, capital Kangar 加央[Jiā yāng]
珠海市	珠海市	Zhū hǎi shì	Zhuhai prefecture level city in Guangdong province 廣東省|广东省[Guǎng dōng shěng] in south China
琿春市	珲春市	Hún chūn shì	Hunchun county level city in Yanbian Korean autonomous prefecture 延邊朝鮮族自治州|延边朝鲜族自治州, Jilin
瑞安市	瑞安市	Ruì ān shì	Rui'an county level city in Wenzhou 溫州|温州[Wēn zhōu], Zhejiang
瑞昌市	瑞昌市	Ruì chāng shì	Ruichang county level city in Jiujiang 九江, Jiangxi
瑞金市	瑞金市	Ruì jīn shì	Ruijin county level city in Ganzhou 贛州|赣州, Jiangxi
瑞麗市	瑞丽市	Ruì lì shì	Ruili city in Dehong Dai and Jingpo autonomous prefecture 德宏傣族景頗族自治州|德宏傣族景颇族自治州[Dé hóng Dǎi zú Jǐng pō zú zì zhì zhōu], Yunnan
瓊山市	琼山市	Qióng shān shì	Qiongshan city, Hainan
瓊海市	琼海市	Qióng hǎi Shì	Qionghai City, Hainan
瓦房店市	瓦房店市	Wǎ fáng diàn shì	Wangfangdian county level city in Dalian 大連|大连[Dà lián], Liaoning
田營市	田营市	Tián yíng shì	Tianying city in Anhui, having lead processing plants that produce substantial pollution
界首市	界首市	Jiè shǒu shì	Jieshou county level city in Fuyang 阜陽|阜阳[Fù yáng], Anhui
畢節市	毕节市	Bì jié shì	Bijie city, capital of Bijie prefecture, Guizhou
當陽市	当阳市	Dāng yáng shì	Dangyan county level city in Yichang 宜昌[Yí chāng], Hubei
畹町市	畹町市	Wǎn dīng shì	Wanding town Dehong Dai and Jingpo autonomous prefecture 德宏傣族景頗族自治州|德宏傣族景颇族自治州, Yunnan, on border with Myanmar (Burma)
登封市	登封市	Dēng fēng shì	Dengfeng county level city in Zhengzhou 鄭州|郑州[Zhèng zhōu], Henan
白城市	白城市	Bái chéng shì	Baicheng prefecture-level city in Jilin province 吉林省 in northeast China
白山市	白山市	Bái shān shì	Baishan prefecture-level city in Jilin province 吉林省 in northeast China
白銀市	白银市	Bái yín shì	Baiyin prefecture-level city in Gansu
百色市	百色市	Bǎi sè shì	Baise prefecture-level city in Guangxi/former pr. [Bó sè]
益陽市	益阳市	Yì yáng shì	Yiyang prefecture level city in Hunan
盤錦市	盘锦市	Pán jǐn shì	Panjin prefecture level city in Liaoning province 遼寧省|辽宁省 in northeast China
目標市場	目标市场	mù biāo shì chǎng	target market
盯市	盯市	dīng shì	mark to market (accounting)
直轄市	直辖市	zhí xiá shì	municipality, namely: Beijing 北京, Tianjin 天津, Shanghai 上海 and Chongqing 重慶|重庆, the first level administrative subdivision/province level city/also called directly governed city
省轄市	省辖市	shěng xiá shì	provincial city
眉山市	眉山市	Méi shān Shì	Meishan prefecture-level city in Sichuan
石咀山市	石咀山市	Shí jǔ shān shì	variant of Shizuishan 石嘴山市[Shí zuǐ shān shì], prefecture level city in Ningxia on the border with Inner Mongolia
石嘴山市	石嘴山市	Shí zuǐ shān shì	Shizuishan prefecture level city in Ningxia on the border with Inner Mongolia
石家莊市	石家庄市	Shí jiā zhuāng Shì	Shijiazhuang prefecture level city and capital of Hebei Province 河北省[Hé běi Shěng] in north China
石河子市	石河子市	Shí hé zǐ shì	Shixenze shehiri (Shixenze city) or Shíhézǐ subprefecture level city in north Xinjiang
石獅市	石狮市	Shí shī shì	Shishi county level city in Quanzhou 泉州[Quán zhōu], Fujian
石首市	石首市	Shí shǒu shì	Shishou county level city in Jingzhou 荊州|荆州[Jīng zhōu], Hubei
磐石市	磐石市	Pán shí shì	Panshi county level city in Jilin prefecture 吉林, Jilin province
福安市	福安市	Fú ān shì	Fu'an county level city in Ningde 寧德|宁德[Níng dé], Fujian
福州市	福州市	Fú zhōu shì	Fuzhou prefecture-level city and capital of Fujian province in east China/formerly known as Foochow or Fuchow
福泉市	福泉市	Fú quán shì	Fuquan county level city in Qiannan Buyei and Miao autonomous prefecture 黔南州[Qián nán zhōu], Guizhou
福清市	福清市	Fú qīng shì	Fuqing county level city in Fuzhou 福州[Fú zhōu], Fujian
福鼎市	福鼎市	Fú dǐng shì	Fuding county level city in Ningde 寧德|宁德[Níng dé], Fujian
禹城市	禹城市	Yǔ chéng shì	Yucheng county level city in Dezhou 德州[Dé zhōu], Shandong
禹州市	禹州市	Yǔ zhōu shì	Yuzhou, county-level city in Xuchang 許昌市|许昌市[Xǔ chāng shì], Henan
秦皇島市	秦皇岛市	Qín huáng dǎo shì	Qinhuangdao prefecture level city in Hebei
穆稜市	穆棱市	Mù líng shì	Muling county level city in Mudanjiang 牡丹江, Heilongjiang
空頭市場	空头市场	kōng tóu shì cháng	bear market
突尼斯市	突尼斯市	Tū ní sī shì	Tunis, capital of Tunisia
窮在鬧市無人問，富在深山有遠親	穷在闹市无人问，富在深山有远亲	qióng zài nào shì wú rén wèn , fù zài shēn shān yǒu yuǎn qīn	the poor are ignored in the busiest city; the rich will find relatives in the deepest mountain
章丘市	章丘市	Zhāng qiū shì	Zhangqiu county level city in Jinan 濟南|济南[Jǐ nán], Shandong
竹北市	竹北市	Zhú běi Shì	Zhubei or Chupei City in Hsinchu County 新竹縣|新竹县[Xīn zhú Xiàn], northwest Taiwan
簡陽市	简阳市	Jiǎn yáng shì	Jianyang county level city in Ziyang 資陽|资阳[Zī yáng], Sichuan
米泉市	米泉市	Mǐ quán shì	Miquan county level city in Changji Hui autonomous prefecture 昌吉回族自治州[Chāng jí Huí zú zì zhì zhōu], Xinjiang
紐約市	纽约市	Niǔ yuē Shì	New York City
紹興市	绍兴市	Shào xīng shì	Shaoxing prefecture level city in Zhejiang
綁赴市曹	绑赴市曹	bǎng fù shì cáo	to bind up and take to the market (idiom); to take a prisoner to the town center for execution
綏化市	绥化市	Suí huà Shì	Suihua prefecture level city in Heilongjiang Province 黑龍江|黑龙江[Hēi lóng jiāng] in northeast China
綏芬河市	绥芬河市	Suí fēn hé shì	Suifenhe county level city in Mudanjiang 牡丹江, Heilongjiang
綿竹市	绵竹市	Mián zhú shì	Mianzhu county level city in Deyang 德陽|德阳[Dé yáng], Sichuan
綿陽市	绵阳市	Mián yáng shì	Mianyang prefecture level city in north Sichuan, Sichuan's second city
縣級市	县级市	xiàn jí shì	county-level city
罷市	罢市	bà shì	protest strike by merchants
羅定市	罗定市	Luó dìng shì	Luoding county level city in Yunfu 雲浮|云浮[Yún fú], Guangdong
義烏市	义乌市	Yì wū shì	Yiwu county level city in Jinhua 金華|金华[Jīn huá], Zhejiang
義馬市	义马市	Yì mǎ shì	Yima county level city in Sanmenxia 三門峽|三门峡[Sān mén xiá], Henan
老河口市	老河口市	Lǎo hé kǒu shì	Laohekou county level city in Xiangfan 襄樊[Xiāng fán], Hubei
考文垂市	考文垂市	Kǎo wén chuí shì	Coventry (UK)
耒陽市	耒阳市	Lěi yáng shì	Leiyang county level city in Hengyang 衡陽|衡阳[Héng yáng], Hunan
聊城市	聊城市	Liáo chéng shì	Liaocheng prefecture-level city in Shandong
肇慶市	肇庆市	Zhào qìng shì	Zhaoqing prefecture level city in Guangdong province 廣東省|广东省[Guǎng dōng shěng] in south China
肇東市	肇东市	Zhào dōng shì	Zhaodong county level city in Suihua 綏化|绥化, Heilongjiang
股市	股市	gǔ shì	stock market
股票市場	股票市场	gǔ piào shì chǎng	stock market/stock exchange
肥城市	肥城市	Féi chéng shì	Feicheng county level city in Tai'an 泰安[Tài ān], Shandong
胡志明市	胡志明市	Hú Zhì míng Shì	Ho Chi Minh City a.k.a. Saigon, Vietnam
膠南市	胶南市	Jiāo nán shì	Jiaonan county level city in Qingdao 青島|青岛, Shandong
膠州市	胶州市	Jiāo zhōu shì	Jiaozhou county level city in Qingdao 青島|青岛, Shandong
臨夏市	临夏市	Lín xià shì	Linxia county level city in Linxia Hui autonomous prefecture 臨夏回族自治州|临夏回族自治州[Lín xià Huí zú zì zhì zhōu], Gansu
臨安市	临安市	Lín ān shì	Lin'an county level city in Hangzhou 杭州[Háng zhōu], Zhejiang
臨時澳門市政執行委員會	临时澳门市政执行委员会	lín shí Ào mén shì zhèng zhí xíng wěi yuán huì	Provisional Municipal Council of Macau/Câmara Municipal de Macau Provisória
臨江市	临江市	Lín jiāng shì	Linjiang county level city in Baishan 白山, Jilin
臨汾市	临汾市	Lín fén shì	Linfen prefecture-level city in Shanxi 山西
臨沂市	临沂市	Lín yí shì	Linyi prefecture-level city in Shandong
臨海市	临海市	Lín hǎi shì	Linhai county level city in Taizhou 台州[Tāi zhōu], Zhejiang
臨清市	临清市	Lín qīng shì	Linqing county level city in Liaocheng 聊城[Liáo chéng], Shandong
臨湘市	临湘市	Lín xiāng shì	Linxiang county-level city in Yueyang 岳陽|岳阳[Yuè yáng], Hunan
臨滄市	临沧市	Lín cāng shì	Lincang prefecture-level city in Yunnan
自治市	自治市	zì zhì shì	municipality/autonomous city/also called directly administered city 直轄市|直辖市
自由市	自由市	Zì yóu shì	Libreville, capital of Gabon (Tw)
自由市場	自由市场	zì yóu shì chǎng	free market
自貢市	自贡市	Zì gòng shì	Zigong prefecture level city in Sichuan
臺中市	台中市	Tái zhōng shì	Taichung city in central Taiwan
臺北市	台北市	Tái běi shì	Taibei or Taipei, capital of Taiwan
臺南市	台南市	Tái nán shì	Tainan city in Tainan county 臺南縣|台南县[Tái nán xiàn], Taiwan
興化市	兴化市	Xīng huà shì	Xinghua county level city in Taizhou 泰州[Tài zhōu], Jiangsu
興城市	兴城市	Xīng chéng Shì	Xincheng county level city in Huludao 葫蘆島|葫芦岛[Hú lú dǎo], Liaoning
興寧市	兴宁市	Xīng níng shì	Xingning county level city in Meizhou 梅州, Guangdong
興平市	兴平市	Xīng píng Shì	Xingping county level city in Xianyang 咸陽|咸阳[Xián yáng], Shaanxi
興義市	兴义市	Xīng yì shì	Xingyi city in Guizhou, capital of Qianxinan Buyei and Miao autonomous prefecture 黔西南布依族苗族自治州
舊貨市場	旧货市场	jiù huò shì chǎng	sale of second-hand goods/flea market
舊車市場	旧车市场	jiù chē shì chǎng	second-hand car market/used bike market
舒蘭市	舒兰市	Shū lán shì	Shulan county level city in Jilin prefecture 吉林, Jilin province
舞鋼市	舞钢市	Wǔ gāng shì	Wugang county level city in Pingdingshan 平頂山|平顶山[Píng dǐng shān], Henan
舟山市	舟山市	Zhōu shān shì	Zhoushan prefecture level city in Zhejiang (consisting solely of islands)/formerly Dinghai 定海
花蓮市	花莲市	Huā lián shì	Hualien city on the east coast of Taiwan
苗栗市	苗栗市	Miáo lì shì	Miaoli city in northwest Taiwan, capital of Miaoli county
英德市	英德市	Yīng dé Shì	Yingde, city in Guangdong
茂名市	茂名市	Mào míng shì	Maoming prefecture-level city in Guangdong province
茶馬互市	茶马互市	Chá mǎ hù shì	old tea-horse market between Tibet, China, Southeast Asia and India, formalized as a state enterprise under the Song dynasty
荊州市	荆州市	Jīng zhōu shì	Jingzhou prefecture-level city on Changjiang in Hubei
荊門市	荆门市	Jīng mén shì	Jingmen prefecture-level city in Hubei
莆田市	莆田市	Pú tián shì	Putian prefecture level city in Fujian
莊河市	庄河市	Zhuāng hé shì	Zhuanghe county level city in Dalian 大連|大连[Dà lián], Liaoning
菏澤市	菏泽市	Hé zé Shì	Heze prefecture-level city in Shandong
菜市	菜市	cài shì	food market
菜市仔名	菜市仔名	cài shì zǐ míng	(Tw) popular given name (one that will turn many heads if you shout it at a marketplace) (from Taiwanese 菜市仔名, Tai-lo pr. [tshài-tshī-á-miâ], where 菜市仔 means "marketplace")
菜市場	菜市场	cài shì chǎng	food market
菜市場名	菜市场名	cài shì chǎng míng	(Tw) popular given name (one that will turn many heads if you shout it at a marketplace)
華鎣市	华蓥市	Huá yíng shì	Huaying county level city in Guang'an 廣安|广安[Guǎng ān], Sichuan
華陰市	华阴市	Huá yīn Shì	Huayin county level city in Weinan 渭南[Wèi nán], Shaanxi
萊州市	莱州市	Lái zhōu shì	Laizhou county level city in Yantai 煙台|烟台, Shandong
萊蕪市	莱芜市	Lái wú shì	Laiwu prefecture-level city in Shandong
萊西市	莱西市	Lái xī shì	Laixi county level city in Qingdao 青島|青岛, Shandong
萊陽市	莱阳市	Lái yáng shì	Laiyang county level city in Yantai 煙台|烟台, Shandong
萍鄉市	萍乡市	Píng xiāng shì	Pingxiang prefecture level city in Jiangxi
萬寧市	万宁市	Wàn níng shì	Wanning City, Hainan
萬源市	万源市	Wàn yuán shì	Wanyuan county level city in Dazhou 達州|达州[Dá zhōu], Sichuan
萬縣市	万县市	Wàn xiàn shì	Wanxian port city on the Changjiang or Yangtze river in Sichuan, renamed Wanzhou district in Chongqing municipality in 1990
葫蘆島市	葫芦岛市	Hú lú dǎo shì	Huludao prefecture-level city in Liaoning province 遼寧省|辽宁省 in northeast China
蒲圻市	蒲圻市	Pú qí shì	Puqi, old name for Chibi county level city 赤壁市[Chì bì shì], Xianning 咸宁市, Hubei
蓋州市	盖州市	Gài zhōu shì	Gaizhou county level city in Yingkou 營口|营口, Liaoning
蓬萊市	蓬莱市	Péng lái shì	Penglai county level city in Yantai 煙台|烟台, Shandong
蔚山市	蔚山市	Wèi shān shì	Ulsan Metropolitan City in South Gyeongsang Province 慶尚南道|庆尚南道[Qìng shàng nán dào], South Korea
蔚山廣域市	蔚山广域市	Wèi shān guǎng yù shì	Ulsan Metropolitan City in South Gyeongsang Province 慶尚南道|庆尚南道[Qìng shàng nán dào], South Korea
蕪湖市	芜湖市	Wú hú shì	Wuhu prefecture level city in Anhui
薑堰市	姜堰市	Jiāng yàn shì	Jiangyan county level city in Taizhou 泰州[Tài zhōu], Jiangsu
薩德爾市	萨德尔市	Sà dé ěr shì	Sadr city (Shia township in East Bagdad)
藁城市	藁城市	Gǎo chéng shì	Gaocheng county level city in Shijiazhuang 石家莊|石家庄[Shí jiā zhuāng], Hebei
蘆洲市	芦洲市	Lú zhōu shì	Luzhou or Luchou city in New Taipei City 新北市[Xīn běi shì], Taiwan
蘇州市	苏州市	Sū zhōu shì	Suzhou prefecture level city in Jiangsu
蘭州市	兰州市	Lán zhōu Shì	Lanzhou prefecture-level city and capital of Gansu province 甘肅|甘肃[Gān sù]
蘭溪市	兰溪市	Lán xī shì	Lanxi county level city in Jinhua 金華|金华[Jīn huá], Zhejiang
虎林市	虎林市	Hǔ lín shì	Hulin county level city in Jixi 雞西|鸡西[Jī xī], Heilongjiang
蚌埠市	蚌埠市	Bèng bù shì	Bengbu prefecture-level city in Anhui
蛟河市	蛟河市	Jiāo hé shì	Jiaohe county level city in Jilin prefecture 吉林, Jilin province
行市	行市	háng shì	quotation on market price
衛輝市	卫辉市	Wèi huī shì	Weihui county in Xinxiang 新鄉|新乡[Xīn xiāng], Henan
衡水市	衡水市	Héng shuǐ shì	Hengshui prefecture-level city in Hebei
衡陽市	衡阳市	Héng yáng shì	Hengyang prefecture-level city in Hunan
衢州市	衢州市	Qú zhōu shì	Quzhou prefecture level city in Zhejiang
襄樊市	襄樊市	Xiāng fán shì	Xiangfan prefecture level city in Hubei
西安市	西安市	Xī ān Shì	Xi’an, sub-provincial city and capital of Shaanxi 陝西省|陕西省[Shǎn xī Shěng] in northwest China
西寧市	西宁市	Xī níng shì	Xining prefecture level city and capital of Qinghai province 青海省[Qīng hǎi shěng] in west China
西市區	西市区	Xī shì Qū	Xishi District of Yingkou City 營口市|营口市[Yíng kǒu shì], Liaoning
西昌市	西昌市	Xī chāng shì	Xichang county level city in Liangshan Yi autonomous prefecture 涼山彞族自治州|凉山彝族自治州[Liáng shān Yí zú zì zhì zhōu], south Sichuan
訥河市	讷河市	Nè hé shì	Nehe county level city in Qiqihar 齊齊哈爾|齐齐哈尔[Qí qí hā ěr], Heilongjiang
許昌市	许昌市	Xǔ chāng shì	Xuchang prefecture level city in north Henan, on the Beijing-Guangzhou railway line
調兵山市	调兵山市	Diào bīng shān shì	Diaobingshan district of Tieling city 鐵嶺市|铁岭市, Liaoning
諸城市	诸城市	Zhū chéng shì	Zhucheng county level city in Weifang 濰坊|潍坊[Wéi fāng], Shandong
諸暨市	诸暨市	Zhū jì shì	Zhuji county level city in Shaoxing 紹興|绍兴[Shào xīng], Zhejiang
證券市場	证券市场	zhèng quàn shì chǎng	financial market
豐原市	丰原市	Fēng yuán shì	Fongyuan or Fengyuan city in Taichung county 臺中縣|台中县[Tái zhōng xiàn], Taiwan
豐城市	丰城市	Fēng chéng shì	Fengcheng county level city in Yichun 宜春, Jiangxi
豐鎮市	丰镇市	Fēng zhèn shì	Fengzhen city in Ulaanchab 烏蘭察布|乌兰察布[Wū lán chá bù], Inner Mongolia
貨幣市場	货币市场	huò bì shì chǎng	money market
貴港市	贵港市	Guì gǎng shì	Guigang prefecture-level city in Guangxi
貴溪市	贵溪市	Guì xī shì	Guixi county level city in Yingtan 鷹潭|鹰潭, Jiangxi
貴陽市	贵阳市	Guì yáng shì	Guiyang prefecture-level city and capital of Guizhou province 貴州|贵州[Guì zhōu]
買方市場	买方市场	mǎi fāng shì chǎng	buyer's market
賀州市	贺州市	Hè zhōu shì	Hezhou prefecture-level city in Guangxi
資本市場	资本市场	zī běn shì chǎng	capital market
資興市	资兴市	Zī xīng shì	Zixing county level city in Chenzhou 郴州[Chēn zhōu], Hunan
資陽市	资阳市	Zī yáng shì	Ziyang prefecture level city in Sichuan
贛州市	赣州市	Gàn zhōu shì	Ganzhou prefecture-level city in Jiangxi
赤壁市	赤壁市	Chì bì shì	Chibi county level city in Xianning 咸宁市, Hubei/Chibi or Redcliff in Huangzhou district 黃州區|黄州区 of Huanggang city 黄冈, Hubei, scene of the famous battle of Redcliff of 208
赤峰市	赤峰市	Chì fēng shì	Chifeng prefecture-level city in Inner Mongolia
赤水市	赤水市	Chì shuǐ shì	Chishui county level city in Zunyi 遵義|遵义[Zūn yì], Guizhou
超市	超市	chāo shì	supermarket/abbr. for 超級市場|超级市场/CL:家[jiā]
超級市場	超级市场	chāo jí shì chǎng	supermarket
跌市	跌市	diē shì	falling stock prices/bear market
跳蚤市場	跳蚤市场	tiào zǎo shì chǎng	flea market
輝縣市	辉县市	Huī xiàn shì	Huixian county in Xinxiang 新鄉|新乡[Xīn xiāng], Henan
辛集市	辛集市	Xīn jí shì	Xinji county level city in Shijiazhuang 石家莊|石家庄[Shí jiā zhuāng], Hebei
農貿市場	农贸市场	nóng mào shì chǎng	farmer's market
通化市	通化市	Tōng huà shì	Tonghua prefecture level city in Jilin province 吉林省 in northeast China
通遼市	通辽市	Tōng liáo shì	Tongliao prefecture level city in Inner Mongolia
連州市	连州市	Lián zhōu shì	Lianzhou county level city in Qingyuan 清远, Guangdong
連雲港市	连云港市	Lián yún gǎng shì	Lianyungang prefecture-level city in Jiangsu
遂寧市	遂宁市	Suì níng shì	Suining prefecture level city in Sichuan
運城市	运城市	Yùn chéng shì	Yuncheng prefecture level city in Shanxi 山西
達州市	达州市	Dá zhōu shì	Dazhou prefecture-level city in Sichuan
遵化市	遵化市	Zūn huà shì	Zunhua county level city in Tangshan 唐山[Táng shān], Hebei
遵義市	遵义市	Zūn yì shì	Zunyi prefecture level city in Guizhou 貴州|贵州[Guì zhōu]
遷安市	迁安市	Qiān ān shì	Qian'an county level city in Tangshan 唐山[Táng shān], Hebei
遼源市	辽源市	Liáo yuán shì	Liaoyuan prefecture-level city in Jilin province 吉林省 in northeast China
遼陽市	辽阳市	Liáo yáng shì	Liaoyang prefecture-level city in Liaoning province 遼寧省|辽宁省 in northeast China
邛崍市	邛崃市	Qióng lái shì	Qionglai county level city in Chengdu 成都[Chéng dū], Sichuan
邢台市	邢台市	Xíng tái shì	Xingtai prefecture level city in Hebei
那曲市	那曲市	Nà qǔ shì	Nagchu city in Tibet
邯鄲市	邯郸市	Hán dān shì	Handan prefecture-level city in Hebei
邳州市	邳州市	Pī zhōu shì	Pizhou city in Xuzhou 徐州[Xú zhōu], Jiangsu
邵武市	邵武市	Shào wǔ shì	Shaowu county level city in Nanping 南平[Nán píng] Fujian
邵陽市	邵阳市	Shào yáng shì	Shaoyang prefecture level city in Hunan
郴州市	郴州市	Chēn zhōu shì	Chenzhou prefecture-level city in Hunan
郵市	邮市	yóu shì	philatelic market
都勻市	都匀市	Dū yún shì	Duyun city in Guizhou, capital of Qiannan Buyei and Miao autonomous prefecture 黔南布依族苗族自治州
都市	都市	dū shì	city/metropolis
都市傳奇	都市传奇	dū shì chuán qí	urban legend (translation of recent Western term)/story or theory circulated as true/same as 都會傳奇|都会传奇
都市化地區	都市化地区	dū shì huà dì qū	urbanized area
都市病	都市病	dū shì bìng	lifestyle diseases
都市美型男	都市美型男	dū shì měi xíng nán	metrosexual
都江堰市	都江堰市	Dū jiāng yàn shì	Dujiangyan county level city in Chengdu 成都[Chéng dū], Sichuan
鄂州市	鄂州市	È zhōu shì	Ezhou prefecture-level city in Hubei
鄂爾多斯市	鄂尔多斯市	È ěr duō sī shì	Ordos prefecture-level city in Inner Mongolia
鄒城市	邹城市	Zōu chéng Shì	Zoucheng county level city in Jining 濟寧|济宁[Jǐ níng], Shandong
鄧州市	邓州市	Dèng zhōu shì	Dengzhou county level city in Nanyang 南陽|南阳[Nán yáng], Henan
鄭州市	郑州市	Zhèng zhōu Shì	Zhengzhou prefecture level city and capital of Henan Province in central China
酒泉市	酒泉市	Jiǔ quán shì	Jiuquan prefecture-level city in Gansu
醴陵市	醴陵市	Lǐ líng shì	Liling prefecture-level city in Zhuzhou 株洲, Hunan
重慶市	重庆市	Chóng qìng shì	Chongqing city, formerly in Sichuan province, a municipality since 1997, short name 渝[Yú]
金壇市	金坛市	Jīn tán shì	Jintan county level city in Changzhou 常州[Cháng zhōu], Jiangsu
金昌市	金昌市	Jīn chāng shì	Jinchang prefecture-level city in Gansu
金華市	金华市	Jīn huá shì	Jinhua prefecture-level city in Zhejiang
金融市場	金融市场	jīn róng shì chǎng	financial market
釜山市	釜山市	Fǔ shān shì	Busan Metropolitan City in South Gyeongsang Province 慶尚南道|庆尚南道[Qìng shàng nán dào], South Korea
釜山廣域市	釜山广域市	Fǔ shān guǎng yù shì	Busan Metropolitan City in South Gyeongsang Province 慶尚南道|庆尚南道[Qìng shàng nán dào], South Korea
銀川市	银川市	Yín chuān Shì	Yinchuan city, capital of Ningxia Hui Autonomous Region 寧夏回族自治區|宁夏回族自治区[Níng xià Huí zú Zì zhì qū]
銅仁市	铜仁市	Tóng rén shì	Tongren city, capital of Tongren prefecture, Guizhou
銅川市	铜川市	Tóng chuān Shì	Tongchuan prefecture level city in Shaanxi
銅陵市	铜陵市	Tóng líng shì	Tongling prefecture level city in Anhui
錦州市	锦州市	Jǐn zhōu shì	Jinzhou prefecture-level city in Liaoning province 遼寧省|辽宁省 in northeast China
錫林浩特市	锡林浩特市	Xī lín hào tè shì	Xilinhaote city in Xilin Gol league 錫林郭勒盟|锡林郭勒盟[Xī lín guō lè méng], Inner Mongolia
鎮江市	镇江市	Zhèn jiāng shì	Zhenjiang prefecture level city in Jiangsu
鐘祥市	钟祥市	Zhōng xiáng shì	Zhongxiang county level city in Jingmen 荊門|荆门[Jīng mén], Hubei
鐵力市	铁力市	Tiě lì shì	Tieli city in Yichun 伊春市[Yī chūn shì], Heilongjiang
鐵嶺市	铁岭市	Tiě lǐng shì	Tieling prefecture level city in Liaoning province 遼寧省|辽宁省 in northeast China
鐵法市	铁法市	Tiě fǎ shì	Tiefa city, now Tieling county level city 鐵嶺市|铁岭市[Tiě lǐng shì], Liaoning
長春市	长春市	Cháng chūn shì	Changchun subprovincial city and capital of Jilin province 吉林省 in northeast China
長樂市	长乐市	Cháng lè shì	Changle county level city in Fuzhou 福州[Fú zhōu], Fujian
長沙市	长沙市	Cháng shā shì	Changsha prefecture-level city and capital of Hunan province in south central China
長治市	长治市	Cháng zhì shì	Changzhi prefecture-level city in Shanxi 山西
長葛市	长葛市	Cháng gě shì	Changge county level city in Shangqiu 商丘[Shāng qiū], Henan
門市	门市	mén shì	retail sales
門市部	门市部	mén shì bù	retail department/section of a retail store
門庭如市	门庭如市	mén tíng rú shì	see 門庭若市|门庭若市[mén tíng ruò shì]
門庭若市	门庭若市	mén tíng ruò shì	front yard as busy as a marketplace (idiom)/a place with many visitors
開原市	开原市	Kāi yuán shì	Kaiyuan county level city in Tieling 鐵嶺|铁岭, Liaoning
開城市	开城市	Kāi chéng shì	Kaesong or Gaeseong city in southwest North Korea, close to the border with South Korea and a special economic zone for South Korean companies
開封市	开封市	Kāi fēng shì	Kaifeng prefecture-level city in Henan, old capital of Northern Song, former provincial capital of Henan/old name Bianliang 汴梁
開市	开市	kāi shì	(of a store, stock market etc) to open for trading/to make the first transaction of the day
開平市	开平市	Kāi píng shì	Kaiping county level city in Jiangmen 江門|江门, Guangdong
開遠市	开远市	Kāi yuǎn shì	Kaiyuan county level city in Honghe Hani and Yi autonomous prefecture, Yunnan
閬中市	阆中市	Láng zhōng shì	Lanzhong county level city in Nanchong 南充[Nán chōng], Sichuan
阜康市	阜康市	Fù kāng shì	Fukang county level city in Changji Hui autonomous prefecture 昌吉回族自治州[Chāng jí Huí zú zì zhì zhōu], Xinjiang
阜新市	阜新市	Fù xīn shì	Fuxin prefecture-level city in Liaoning province 遼寧省|辽宁省 in northeast China
阜陽市	阜阳市	Fù yáng shì	Fuyang prefecture-level city in Anhui
防城港市	防城港市	Fáng chéng gǎng shì	Fangchenggang prefecture-level city in Guangxi
阿克蘇市	阿克苏市	Ā kè sū shì	Aqsu shehiri or Aksu city in Aksu prefecture, Xinjiang
阿勒泰市	阿勒泰市	Ā lè tài shì	Altay prefecture-level city in Xinjiang
阿圖什市	阿图什市	Ā tú shí shì	Atush or Artux city in Qizilsu Kyrgyz autonomous prefecture in Xinjiang 克孜勒蘇柯爾克孜自治州|克孜勒苏柯尔克孜自治州/Atushi city near Kashgar in Xinjiang
阿拉伯共衕市場	阿拉伯共同市场	Ā lā bó Gòng tóng Shì chǎng	Arab Common Market
阿拉爾市	阿拉尔市	Ā lā ěr shì	Aral shehiri (Aral city) or Ālā'ěr subprefecture level city in west Xinjiang
阿爾山市	阿尔山市	Ā ěr shān shì	Arxan county level city, Mongolian Rashaant xot, in Hinggan league 興安盟|兴安盟[Xīng ān méng], east Inner Mongolia
陸豐市	陆丰市	Lù fēng shì	Lufeng county level city in Shanwei 汕尾, Guangdong
陽春市	阳春市	Yáng chūn shì	Yangchun county level city in Yangjiang 陽江|阳江[Yáng jiāng], Guangdong
陽江市	阳江市	Yáng jiāng shì	Yangjiang prefecture level city in Guangdong
陽泉市	阳泉市	Yáng quán shì	Yangquan prefecture level city in Shanxi 山西
隨州市	随州市	Suí zhōu shì	Suizhou prefecture level city in Hubei
隨行就市	随行就市	suí háng jiù shì	(of a price) to fluctuate according to the market/to sell at the market price
隴南市	陇南市	Lǒng nán shì	Longnan prefecture-level city in south Gansu
雅安市	雅安市	Yǎ ān shì	Ya'an prefecture level city in Sichuan
集安市	集安市	Jí ān shì	Ji'an county level city in Tonghua 通化, Jilin
集市	集市	jí shì	market/bazaar/fair
集市貿易	集市贸易	jí shì mào yì	market trade
雙城市	双城市	Shuāng chéng shì	Suangcheng county level city in Harbin 哈爾濱|哈尔滨[Hā ěr bīn], Heilongjiang
雙遼市	双辽市	Shuāng liáo shì	Shuangliao county level city in Siping 四平, Jilin
雙鴨山市	双鸭山市	Shuāng yā shān shì	Shuangyashan prefecture level city in Heilongjiang province 黑龍江|黑龙江[Hēi lóng jiāng] in northeast China
雞西市	鸡西市	Jī xī shì	Jixi prefecture-level city in Heilongjiang province 黑龍江|黑龙江[Hēi lóng jiāng] in northeast China
雲浮市	云浮市	Yún fú shì	Yunfu prefecture level city in Guangdong province 廣東省|广东省[Guǎng dōng shěng] in south China
雷州市	雷州市	Léi zhōu shì	Leizhou county level city in Zhanjiang 湛江[Zhàn jiāng], Guangdong
霍州市	霍州市	Huò zhōu shì	Huozhou county level city in Linfen 臨汾|临汾[Lín fén], Shanxi
霍林郭勒市	霍林郭勒市	Huò lín guō lè shì	Huolin Gol county level city in Tongliao 通遼|通辽[Tōng liáo], Inner Mongolia
霸州市	霸州市	Bà zhōu shì	Bazhou county level city in Langfang 廊坊[Láng fáng], Hebei
靈寶市	灵宝市	Líng bǎo shì	Lingbao county level city in Sanmenxia 三門峽|三门峡[Sān mén xiá], Henan
靈武市	灵武市	Líng wǔ shì	Lingwu county level city in Yinchuan 銀川|银川[Yín chuān], Ningxia
青島市	青岛市	Qīng dǎo shì	Qingdao, subprovincial city in Shandong
青州市	青州市	Qīng zhōu shì	Qingzhou county level city in Weifang 濰坊|潍坊[Wéi fāng], Shandong
青銅峽市	青铜峡市	Qīng tóng xiá shì	Qingtong county level city in Wuzhong 吳忠|吴忠[Wú zhōng], Ningxia
靖江市	靖江市	Jìng jiāng shì	Jingjiang county level city in Taizhou 泰州[Tài zhōu], Jiangsu
面市	面市	miàn shì	to hit the market (of a new product)
鞍山市	鞍山市	Ān shān shì	Anshan prefecture-level city in Liaoning province 遼寧省|辽宁省 in northeast China
鞏義市	巩义市	Gǒng yì shì	Gongyi county level city in Zhengzhou 鄭州|郑州[Zhèng zhōu], Henan
韓城市	韩城市	Hán chéng shì	Hancheng city in Shaanxi
韶山市	韶山市	Sháo shān shì	Shaoshan county level city in Xiangtan 湘潭[Xiāng tán], Hunan
韶關市	韶关市	Sháo guān shì	Shaoguan prefecture level city in Guangdong province
項城市	项城市	Xiàng chéng shì	Xiangcheng county level city in Zhoukou 周口, Henan
額爾古納市	额尔古纳市	É ěr gǔ nà shì	Ergun county level city, Mongolian Ergüne xot, in Hulunbuir 呼倫貝爾|呼伦贝尔[Hū lún bèi ěr], Inner Mongolia
餘姚市	余姚市	Yú yáo shì	Yuyao county level city in Ningbo 寧波|宁波[Níng bō], Zhejiang
首爾特別市	首尔特别市	Shǒu ěr Tè bié shì	Seoul Special Metropolitan City, official name of the capital of South Korea
馬公市	马公市	Mǎ gōng shì	Makung city in Penghu county 澎湖縣|澎湖县[Péng hú xiàn] (Pescadores Islands), Taiwan
馬鞍山市	马鞍山市	Mǎ ān shān shì	Ma'anshan prefecture-level city in Anhui
駐馬店市	驻马店市	Zhù mǎ diàn shì	Zhumadian prefecture level city in Henan
高安市	高安市	Gāo ān shì	Gao'an county level city in Yichun 宜春, Jiangxi
高密市	高密市	Gāo mì shì	Gaomi county level city in Weifang 濰坊|潍坊[Wéi fāng], Shandong
高州市	高州市	Gāo zhōu shì	Gaozhou county level city in Maoming 茂名, Guangdong
高平市	高平市	Gāo píng shì	Gaoping county level city in Jincheng 晉城|晋城[Jìn chéng], Shanxi
高梁市	高梁市	Gāo liáng shì	Takahashi city in Okayama prefecture 岡山縣|冈山县[Gāng shān xiàn], Japan
高碑店市	高碑店市	Gāo bēi diàn shì	Gaobeidian county level city in Baoding 保定[Bǎo dìng], Hebei
高要市	高要市	Gāo yào shì	Gaoyao county level city in Zhaoqing 肇慶|肇庆[Zhào qìng], Guangdong
高郵市	高邮市	Gāo yóu shì	Gaoyou county level city in Yangzhou 揚州|扬州[Yáng zhōu], Jiangsu
高雄市	高雄市	Gāo xióng shì	Kaohsiung or Gaoxiong city in south Taiwan
鬆滋市	松滋市	Sōng zī shì	Songzi county level city in Jingzhou 荊州|荆州[Jīng zhōu], Hubei
鬧市	闹市	nào shì	downtown area/city center
魁北克市	魁北克市	Kuí běi kè shì	Quebec city, capital of Quebec province of Canada
鳳城市	凤城市	Fèng chéng shì	Fengcheng county level city in Dandong 丹東|丹东[Dān dōng], Liaoning
鳳山市	凤山市	Fèng shān shì	Fengshan city in Taiwan
鶴壁市	鹤壁市	Hè bì shì	Hebi prefecture-level city in Henan
鶴山市	鹤山市	Hè shān shì	Heshan county level city in Jiangmen 江門|江门, Guangdong
鶴崗市	鹤岗市	Hè gǎng shì	Hegang prefecture-level city in Heilongjiang province 黑龍江|黑龙江[Hēi lóng jiāng] in northeast China
鷹潭市	鹰潭市	Yīng tán shì	Yingtan prefecture level city in Jiangxi
鹽城市	盐城市	Yán chéng shì	Yancheng prefecture level city in Jiangsu
鹿泉市	鹿泉市	Lù quán shì	Luquan county level city in Shijiazhuang 石家莊|石家庄[Shí jiā zhuāng], Hebei
麗水市	丽水市	Lí shuǐ shì	Lishui prefecture-level city in Zhejiang/Yeosu city in South Jeolla province, Korea, the site of World Expo 2012
麗江市	丽江市	Lì jiāng shì	Lijiang prefecture-level city in northwest Yunnan
麻城市	麻城市	Má chéng shì	Macheng county level city in Huanggang 黃岡|黄冈[Huáng gāng], Hubei
黃山市	黄山市	Huáng shān shì	Huangshan prefecture-level city centered around Huangshan Mountains in south Anhui
黃岡市	黄冈市	Huáng gāng shì	Huanggang prefecture-level city in Hubei
黃石市	黄石市	Huáng shí shì	Huangshi prefecture-level city in Hubei
黃驊市	黄骅市	Huáng huá shì	Huanghua county level city in Cangzhou 滄州|沧州[Cāng zhōu], Hebei
黑市	黑市	hēi shì	black market
黑河市	黑河市	Hēi hé shì	Heihe prefecture-level city in Heilongjiang province 黑龍江|黑龙江[Hēi lóng jiāng] in northeast China
齊齊哈爾市	齐齐哈尔市	Qí qí hā ěr shì	Qiqihar prefecture level city in Heilongjiang province 黑龍江|黑龙江[Hēi lóng jiāng] in northeast China
龍井市	龙井市	Lóng jǐng shì	Longjing county level city in Yanbian Korean autonomous prefecture 延邊朝鮮族自治州|延边朝鲜族自治州, Jilin
龍口市	龙口市	Lóng kǒu shì	Longkou county level city in Yantai 煙台|烟台, Shandong
龍岩市	龙岩市	Lóng yán shì	Longyan prefecture-level city in Fujian
龍泉市	龙泉市	Lóng quán shì	Longquan county level city in Lishui 麗水|丽水[Lí shuǐ], Zhejiang
龍海市	龙海市	Lóng hǎi shì	Longhai county level city in Zhangzhou 漳州[Zhāng zhōu], Fujian
龜尾市	龟尾市	Guī wěi shì	Gumi city in North Gyeongsang Province, South Korea
