旤	祸	huò	old variant of 禍|祸[huò]
禍	祸	huò	disaster/misfortune/calamity
包藏禍心	包藏祸心	bāo cáng huò xīn	to harbor evil intentions (idiom); concealing malice
因禍得福	因祸得福	yīn huò dé fú	to profit from a disaster (idiom); some good comes out of a setback/It's an ill wind that blows nobody any good.
大禍	大祸	dà huò	disaster/calamity
大禍臨頭	大祸临头	dà huò lín tóu	facing imminent catastrophe/calamity looms/all hell will break loose
天有不測風雲，人有旦夕禍福	天有不测风云，人有旦夕祸福	tiān yǒu bù cè fēng yún , rén yǒu dàn xī huò fú	fortune as unpredictable as the weather, every day may bring fortune or calamity (idiom); sth unexpected may happen at any moment
天災人禍	天灾人祸	tiān zāi rén huò	natural calamities and man-made disasters (idiom)
奇禍	奇祸	qí huò	unexpected calamity/sudden disaster
嫁禍	嫁祸	jià huò	to impute/to shift the blame onto someone else
嫁禍於人	嫁祸于人	jià huò yú rén	to pass the misfortune on to sb else (idiom); to blame others/to pass the buck
巫蠱之禍	巫蛊之祸	wū gǔ zhī huò	91 BC attempted coup d'etat against Emperor Wu of Han 漢武帝|汉武帝, beginning with accusations of witchcraft
幸災樂禍	幸灾乐祸	xìng zāi lè huò	lit. to take joy in calamity and delight in disaster (idiom); fig. to rejoice in other people's misfortune/Schadenfreude
惹禍	惹祸	rě huò	to stir up trouble/to invite disaster
慘禍	惨祸	cǎn huò	terrible tragedy/grave mishap
戰禍	战祸	zhàn huò	disaster of war
戳禍	戳祸	chuō huò	to stir up trouble
招災惹禍	招灾惹祸	zhāo zāi rě huò	to invite disaster
人禍	人祸	rén huò	human disaster
有福同享，有禍同當	有福同享，有祸同当	yǒu fú tóng xiǎng , yǒu huò tóng dāng	To enjoy blessings and endure misfortune together (idiom); for better or for worse
橫禍	横祸	hèng huò	unexpected calamity
災禍	灾祸	zāi huò	disaster
病從口入，禍從口出	病从口入，祸从口出	bìng cóng kǒu rù , huò cóng kǒu chū	Illness enters by the mouth, trouble comes out by the mouth (idiom). A loose tongue may cause a lot of trouble.
兵連禍結	兵连祸结	bīng lián huò jié	ravaged by successive wars/war-torn/war-ridden
禍不單行	祸不单行	huò bù dān xíng	misfortune does not come singly (idiom)/it never rains but it pours
禍不旋踵	祸不旋踵	huò bù xuán zhǒng	trouble is never far away (idiom)
禍亂	祸乱	huò luàn	calamity and chaos/devastating disorder/great turmoil
禍事	祸事	huò shì	disaster/doom
禍國殃民	祸国殃民	huò guó yāng mín	to damage the country and cause suffering to the people (idiom)
禍害	祸害	huò hài	disaster/harm/scourge/bad person/to damage/to harm/to wreck
禍從口出	祸从口出	huò cóng kǒu chū	Trouble issues from the mouth (idiom). A loose tongue may cause a lot of trouble.
禍患	祸患	huò huàn	disaster/calamity
禍根	祸根	huò gēn	root of the trouble/cause of the ruin
禍水	祸水	huò shuǐ	source of calamity (esp. of women)
禍福	祸福	huò fú	disaster and happiness
禍福吉凶	祸福吉凶	huò fú jí xiōng	fate/portent/luck or disasters as foretold in the stars (astrology)
禍福無常	祸福无常	huò fú wú cháng	disaster and happiness do not follow rules (idiom); future blessings and misfortunes are unpredictable
禍福與共	祸福与共	huò fú yǔ gòng	to stick together through thick and thin (idiom)
禍首	祸首	huò shǒu	chief offender/main culprit
禍首罪魁	祸首罪魁	huò shǒu zuì kuí	main offender, criminal ringleader (idiom); main culprit/fig. main cause of a disaster
紅顏禍水	红颜祸水	hóng yán huò shuǐ	femme fatale
罪魁禍首	罪魁祸首	zuì kuí huò shǒu	criminal ringleader, main offender (idiom); main culprit/fig. main cause of a disaster
罹禍	罹祸	lí huò	to suffer a disaster/to fall victim to misfortune
肇禍	肇祸	zhào huò	to cause an accident
苞藏禍心	苞藏祸心	bāo cáng huò xīn	to harbor evil intentions (idiom); concealing malice
車禍	车祸	chē huò	traffic accident/car crash/CL:場|场[cháng]
闖禍	闯祸	chuǎng huò	to cause an accident/to make trouble/to get into trouble
飛來橫禍	飞来横祸	fēi lái hèng huò	sudden and unexpected disaster (idiom)
黃禍	黄祸	Huáng huò	Yellow Peril, political novel by Wang Lixiong 王力雄[Wáng Lì xióng]
黃禍	黄祸	huáng huò	yellow peril (offensive term referring to the perceived threat to Western nations, of immigration or military expansion from East Asian nations)
