御	御	yù	to resist/imperial/(classical) to drive (a chariot)/to manage/to govern
禦	御	yù	to defend/to resist
守禦	守御	shǒu yù	to defend
兄弟鬩於墻，外禦其侮	兄弟阋于墙，外御其侮	xiōng dì xì yú qiáng , wài yù qí wǔ	internal disunity dissolves at the threat of an invasion from outside (idiom)
御便當	御便当	yù biàn dāng	(Tw) bento/lunch box
御史	御史	yù shǐ	imperial censor (formal title of a dynastic official)
御宅族	御宅族	yù zhái zú	otaku, a Japanese term for people with obsessive interests such as anime, manga, and video games/see also 宅男[zhái nán]/see also 宅女[zhái nǚ]
御寶	御宝	yù bǎo	imperial seal
御廚	御厨	yù chú	imperial chef/imperial kitchen
御弟	御弟	yù dì	emperor's young brother
御戎	御戎	yù róng	(military) chariot driver (old)
御手	御手	yù shǒu	the emperor's hand/variant of 馭手|驭手[yù shǒu]
御用	御用	yù yòng	for use by the emperor/imperial/(derog.) in the pay of the ruler
御用大律師	御用大律师	yù yòng dà lǜ shī	Queen's Counsel
御膳房	御膳房	yù shàn fáng	imperial kitchen
御賜	御赐	yù cì	to be bestowed, conferred, or granted by the emperor
御酒	御酒	yù jiǔ	imperial wine/sacred wine
御醫	御医	yù yī	imperial physician
御駕親征	御驾亲征	yù jià qīn zhēng	the emperor leads his troops into battle (idiom)/to take part personally in an expedition
戰略防御倡議	战略防御倡议	zhàn lüè fáng yù chàng yì	strategic defense initiative (SDI)
抵禦	抵御	dǐ yù	to resist/to withstand
提學御史	提学御史	tí xué yù shǐ	superintendent of education (formal title)
核防御	核防御	hé fáng yù	nuclear defense
太平御覽	太平御览	Tài píng Yù lǎn	Imperial Readings of the Taiping Era, general Song dynasty encyclopedia compiled during 977-983 under Li Fang 李昉[Lǐ Fǎng], 1000 scrolls
禦夫座	御夫座	Yù fū zuò	Auriga (constellation)
禦寒	御寒	yù hán	to defend against the cold/to keep warm
禦敵	御敌	yù dí	armed enemy of the nation/enemy of the Emperor/fig. championship challenger/contender opposing champion in sporting contest
統御	统御	tǒng yù	control
防禦	防御	fáng yù	defense/to defend
防禦工事	防御工事	fáng yù gōng shì	fortification/defensive structure
防禦性	防御性	fáng yù xìng	defensive (weapons)
防禦率	防御率	fáng yù lǜ	earned run average (baseball)
防禦術	防御术	fáng yù shù	defensive art
駕御	驾御	jià yù	variant of 駕馭|驾驭[jià yù]
