跳	跳	tiào	to jump/to hop/to skip over/to bounce/to palpitate
三級跳遠	三级跳远	sān jí tiào yuǎn	triple jump (athletics)/hop, skip and jump
亂跳	乱跳	luàn tiào	to jump about/(of the heart) to beat wildly
低空跳傘	低空跳伞	dī kōng tiào sǎn	BASE Jumping
佛跳牆	佛跳墙	fó tiào qiáng	lit. Buddha jumps over the wall, name for a Chinese dish that uses many non-vegetarian ingredients
單腳跳	单脚跳	dān jiǎo tiào	to hop/to jump on one leg
嚇一跳	吓一跳	xià yī tiào	startled/to frighten/scared out of one's skin
國際跳棋	国际跳棋	guó jì tiào qí	checkers (Western board game)
大五趾跳鼠	大五趾跳鼠	dà wǔ zhǐ tiào shǔ	great jerboa (Allactaga major)
字節跳動	字节跳动	Zì jié Tiào dòng	ByteDance, Beijing-based Internet technology company, founded in 2012
彈跳	弹跳	tán tiào	to bounce/to jump/to leap
彈跳板	弹跳板	tán tiào bǎn	springboard
心怦怦跳	心怦怦跳	xīn pēng pēng tiào	The heart thumps wildly. (idiom)
心砰砰跳	心砰砰跳	xīn pēng pēng tiào	variant of 心怦怦跳[xīn pēng pēng tiào]
心跳	心跳	xīn tiào	heartbeat/pulse
心跳過緩	心跳过缓	xīn tiào guò huǎn	bradycardia
心驚肉跳	心惊肉跳	xīn jīng ròu tiào	lit. heart alarmed, body leaping (idiom); fear and trepidation in the face of disaster
撐桿跳	撑杆跳	chēng gān tiào	pole-vaulting
撐桿跳高	撑杆跳高	chēng gān tiào gāo	pole-vaulting
撐竿跳	撑竿跳	chēng gān tiào	pole-vaulting/also written 撐桿跳|撑杆跳
撐竿跳高	撑竿跳高	chēng gān tiào gāo	pole vault/also written 撐桿跳高|撑杆跳高
暴跳如雷	暴跳如雷	bào tiào rú léi	stamp with fury/fly into a rage
歡蹦亂跳	欢蹦乱跳	huān bèng luàn tiào	glowing with health and vivacity (idiom)
波比跳	波比跳	bō bǐ tiào	burpee (loanword)
活蹦亂跳	活蹦乱跳	huó bèng luàn tiào	to leap and frisk about (idiom); lively/healthy and active
特技跳傘	特技跳伞	tè jì tiào sǎn	skydiving
狗急跳牆	狗急跳墙	gǒu jí tiào qiáng	a cornered dog will jump over the wall (idiom)/to be driven to desperate action
獨腳跳	独脚跳	dú jiǎo tiào	to jump on one foot/to hop
眼跳	眼跳	yǎn tiào	twitching of eye
眼跳動	眼跳动	yǎn tiào dòng	saccade
立定跳遠	立定跳远	lì dìng tiào yuǎn	standing long jump
虎跳峽	虎跳峡	Hǔ tiào Xiá	Tiger Leaping Gorge on the Jinsha River 金沙江[Jīn shā jiāng] in Lijiang Naxi autonomous county 麗江納西族自治縣|丽江纳西族自治县[Lì jiāng Nà xī zú Zì zhì xiàn], Yunnan
三級跳	三级跳	sān jí tiào	triple jump (athletics)/hop, skip and jump
跳一隻腳	跳一只脚	tiào yī zhī jiǎo	to hop on one leg
跳井	跳井	tiào jǐng	to jump into a well (to drown oneself, esp. of ladies in fiction)
跳傘	跳伞	tiào sǎn	to parachute/to bail out/parachute jumping
跳價	跳价	tiào jià	price jump
跳出	跳出	tiào chū	to jump out/fig. to appear suddenly
跳出火坑	跳出火坑	tiào chū huǒ kēng	lit. to jump out of a fire pit (idiom); to escape from a living hell/to free oneself from a life of torture
跳出釜底進火坑	跳出釜底进火坑	tiào chū fǔ dǐ jìn huǒ kēng	out of the frying pan into the fire (idiom)
跳動	跳动	tiào dòng	to throb/to pulse/to bounce/to jiggle/to jump about
跳彈	跳弹	tiào dàn	ricochet
跳房子	跳房子	tiào fáng zi	hopscotch/to play hopscotch
跳擋	跳挡	tiào dǎng	(of a car) to slip out of gear/to pop out of gear
跳板	跳板	tiào bǎn	springboard/jumping-off point/gangplank
跳棋	跳棋	tiào qí	Chinese checkers
跳槽	跳槽	tiào cáo	to change jobs/job-hopping
跳樓	跳楼	tiào lóu	to jump from a building (to kill oneself)/fig. to sell at a large discount (in advertising)
跳樓價	跳楼价	tiào lóu jià	extremely low price/knockdown price
跳水	跳水	tiào shuǐ	to dive (into water)/(sports) diving/to commit suicide by jumping into water/(fig.) (of stock prices etc) to fall dramatically
跳河	跳河	tiào hé	to drown oneself by jumping into the river
跳皮筋	跳皮筋	tiào pí jīn	to play rubber band jump rope
跳票	跳票	tiào piào	bounced (bank) check
跳級	跳级	tiào jí	to jump a year (at college)
跳級生	跳级生	tiào jí shēng	student who jumps a year
跳繩	跳绳	tiào shéng	to jump rope/jump rope
跳腳	跳脚	tiào jiǎo	to stomp or hop about (in anxiety, anger etc)/to dance on one's feet/hopping mad (anxious, etc)
跳臺	跳台	tiào tái	diving platform/diving tower/landing platform
跳臺滑雪	跳台滑雪	tiào tái huá xuě	ski jumping
跳舞	跳舞	tiào wǔ	to dance
跳蚤	跳蚤	tiào zao	flea
跳蚤市場	跳蚤市场	tiào zǎo shì chǎng	flea market
跳蛋	跳蛋	tiào dàn	love egg (sex toy)
跳蛛	跳蛛	tiào zhū	jumping spider (family Salticidae)
跳跳糖	跳跳糖	tiào tiào táng	Pop Rocks/popping candy
跳躍	跳跃	tiào yuè	to jump/to leap/to bound/to skip
跳進	跳进	tiào jìn	to plunge into/to jump into
跳進黃河洗不清	跳进黄河洗不清	tiào jìn Huáng Hé xǐ bù qīng	lit. even jumping into the Yellow River can't get you clean/fig. to become inexorably mixed up/mired in controversy/in deep trouble
跳遠	跳远	tiào yuǎn	long jump (athletics)
跳閘	跳闸	tiào zhá	(of a circuit breaker or switch) to trip
跳集體舞	跳集体舞	tiào jí tǐ wǔ	to do ensemble dancing/to dance in a group
跳電	跳电	tiào diàn	(of a circuit breaker or switch) to trip
跳頻	跳频	tiào pín	frequency-hopping spread spectrum
跳馬	跳马	tiào mǎ	vault (gymnastics)
跳高	跳高	tiào gāo	high jump (athletics)
蹦跳	蹦跳	bèng tiào	to hop/to jump
蹦蹦跳跳	蹦蹦跳跳	bèng bèng tiào tiào	bouncing and vivacious
躥跳	蹿跳	cuān tiào	to bound forward/to bound along
造型跳傘	造型跳伞	zào xíng tiào sǎn	formation skydiving
雞飛狗跳	鸡飞狗跳	jī fēi gǒu tiào	lit. chickens flying and dogs jumping (idiom)/fig. in chaos/in disarray
驚跳	惊跳	jīng tiào	to shy (away)/to give a start
高空彈跳	高空弹跳	gāo kōng tán tiào	bungee jumping (Tw)
鯉魚跳龍門	鲤鱼跳龙门	lǐ yú tiào lóng mén	to make a significant advance in one's career (idiom)/to get one's big break
