悲	悲	bēi	sad/sadness/sorrow/grief
假慈悲	假慈悲	jiǎ cí bēi	phoney mercy/sham benevolence/crocodile tears
傷悲	伤悲	shāng bēi	sad/sorrowful (literary)
兔死狐悲	兔死狐悲	tù sǐ hú bēi	lit. if the rabbit dies, the fox grieves (idiom); fig. to have sympathy with a like-minded person in distress
公地悲劇	公地悲剧	gōng dì bēi jù	tragedy of the commons (economics)
可悲	可悲	kě bēi	lamentable
大悲咒	大悲咒	Dà bēi zhòu	the Great Compassion Mantra
大放悲聲	大放悲声	dà fàng bēi shēng	to wail loudly and mournfully (idiom)
少壯不努力，老大徒傷悲	少壮不努力，老大徒伤悲	shào zhuàng bù nǔ lì , lǎo dà tú shāng bēi	if you are lazy in your prime, you'll be sorry in your old age
強忍悲痛	强忍悲痛	qiáng rěn bēi tòng	to try hard to suppress one's grief (idiom)
徐悲鴻	徐悲鸿	Xú Bēi hóng	Xu Beihong (1895-1953), famous European trained painter and influential art teacher
不以物喜，不以己悲	不以物喜，不以己悲	bù yǐ wù xǐ , bù yǐ jǐ bēi	not to become attached to material things, not to pity oneself
悲不自勝	悲不自胜	bēi bù zì shèng	unable to control one's grief (idiom); overwrought/overcome with sorrow/heartbroken
悲催	悲催	bēi cuī	(Internet slang) miserable/pathetic/the pits
悲傷	悲伤	bēi shāng	sad/sorrowful
悲切	悲切	bēi qiè	mournful
悲劇	悲剧	bēi jù	tragedy/CL:齣|出[chū]
悲劇性	悲剧性	bēi jù xìng	tragic
悲劇缺陷	悲剧缺陷	bēi jù quē xiàn	tragic flaw (Aristotle's hamartia)
悲哀	悲哀	bēi āi	grieved/sorrowful
悲哽	悲哽	bēi gěng	to choke with grief
悲啼	悲啼	bēi tí	to wail with grief/plaintive cry
悲喜交集	悲喜交集	bēi xǐ jiāo jí	mixed feelings of grief and joy
悲喜劇	悲喜剧	bēi xǐ jù	tragicomedy
悲嘆	悲叹	bēi tàn	to bewail/to sigh mournfully/to lament
悲壯	悲壮	bēi zhuàng	solemn and stirring/moving and tragic
悲天憫人	悲天悯人	bēi tiān mǐn rén	to bemoan the state of the universe and pity the fate of mankind
悲悼	悲悼	bēi dào	mourn/grieve over sb's death
悲悽	悲凄	bēi qī	pitiable/sorrowful
悲惻	悲恻	bēi cè	grieved/sorrowful
悲愁	悲愁	bēi chóu	melancholy
悲愴	悲怆	bēi chuàng	sorrow/tragic
悲慘	悲惨	bēi cǎn	miserable/tragic
悲慘世界	悲惨世界	Bēi cǎn Shì jiè	Les Misérables (1862) by Victor Hugo 維克多·雨果|维克多·雨果[Wéi kè duō · Yǔ guǒ]
悲慟	悲恸	bēi tòng	mournful
悲憤	悲愤	bēi fèn	grief and indignation
悲憫	悲悯	bēi mǐn	to take pity on sb/compassionate
悲戚	悲戚	bēi qī	mournful
悲摧	悲摧	bēi cuī	grieved/miserable
悲楚	悲楚	bēi chǔ	sorrowful/grieved
悲歌	悲歌	bēi gē	sad melody/stirring strains/elegy/dirge/threnody/sing with solemn fervor
悲歌當哭	悲歌当哭	bēi gē dàng kū	to sing instead of weep (idiom)
悲歎	悲叹	bēi tàn	to bewail/to sigh mournfully/to lament
悲歡離合	悲欢离合	bēi huān lí hé	joys and sorrows/partings and reunions/the vicissitudes of life
悲泣	悲泣	bēi qì	to weep with grief
悲涼	悲凉	bēi liáng	sorrowful/dismal
悲痛	悲痛	bēi tòng	grieved/sorrowful
悲聲載道	悲声载道	bēi shēng zài dào	lamentations fill the roads (idiom); severe suffering all around
悲苦	悲苦	bēi kǔ	forlorn/miserable
悲觀	悲观	bēi guān	pessimistic
悲酸	悲酸	bēi suān	bitter and sad
悲鳴	悲鸣	bēi míng	utter sad calls/lament
慈悲	慈悲	cí bēi	mercy
慈悲為本	慈悲为本	cí bēi wéi běn	mercy as the guiding principle (idiom); the Buddhist teaching that nothing is valid except compassion
樂極生悲	乐极生悲	lè jí shēng bēi	extreme joy turns to sorrow (idiom); Don't celebrate too soon, things could still go wrong!
老大徒傷悲	老大徒伤悲	lǎo dà tú shāng bēi	vain regrets of old age (idiom)
轉悲為喜	转悲为喜	zhuǎn bēi wéi xǐ	to turn grief into happiness (idiom)
