㪚	散	sàn	variant of 散[sàn]
散	散	sǎn	scattered/loose/to come loose/to fall apart/leisurely/powdered medicine
散	散	sàn	to scatter/to break up (a meeting etc)/to disperse/to disseminate/to dispel/(coll.) to sack
一盤散沙	一盘散沙	yī pán sǎn shā	lit. like a sheet of loose sand/fig. unable to cooperate (idiom)
一鬨而散	一哄而散	yī hòng ér sàn	see 一哄而散[yī hōng ér sàn]
不擴散核武器條約	不扩散核武器条约	Bù Kuò sàn Hé wǔ qì Tiáo yuē	Treaty on the Non-Proliferation of Nuclear Weapons
不歡而散	不欢而散	bù huān ér sàn	to part on bad terms/(of a meeting etc) to break up in discord
不見不散	不见不散	bù jiàn bù sàn	lit. Even if we don't see each other, don't give up and leave (idiom)/fig. Be sure to wait!/See you there!
五苓散	五苓散	wǔ líng sǎn	wuling powder (decoction of poria mushroom used in TCM)/poria five powder/Hoelen five powder/five ling powder
人心渙散	人心涣散	rén xīn huàn sàn	(of a nation, government etc) demoralized/disunited
作鳥獸散	作鸟兽散	zuò niǎo shòu sàn	lit. scatter like birds and beasts (idiom)/fig. to head off in various directions/to flee helter-skelter
光纖分散式資料介面	光纤分散式资料介面	guāng xiān fēn sàn shì zī liào jiè miàn	fiber distributed data interface/FDDI
冗散	冗散	rǒng sǎn	idle/unemployed
分散	分散	fēn sàn	to scatter/to disperse/to distribute
分散和弦	分散和弦	fēn sàn hé xián	(music) arpeggio
分散式	分散式	fēn sàn shì	distributed
分散的策略	分散的策略	fēn sàn de cè lüè	diffused strategy
千里搭長棚，沒有不散的宴席	千里搭长棚，没有不散的宴席	qiān lǐ dā cháng péng , méi yǒu bù sàn de yàn xí	even if you build a thousand-league awning for it, every banquet must come to an end (idiom)
反散射	反散射	fǎn sàn shè	backscatter
吹散	吹散	chuī sàn	to disperse
和散那	和散那	hé sǎn nà	Hosanna (in Christian praise)
四散	四散	sì sàn	to disperse/to scatter in all directions
四散奔逃	四散奔逃	sì sàn bēn táo	to scatter in all directions
天下沒有不散的宴席	天下没有不散的宴席	tiān xià méi yǒu bù sàn de yàn xí	see 天下沒有不散的筵席|天下没有不散的筵席[tiān xià méi yǒu bù sàn de yán xí]
天下沒有不散的筵席	天下没有不散的筵席	tiān xià méi yǒu bù sàn de yán xí	all good things must come to an end (idiom)
失散	失散	shī sàn	to lose touch with/missing/scattered/separated from
好聚好散	好聚好散	hǎo jù hǎo sàn	to part without hard feelings (idiom)/to cut the knot as smoothly as you tied it
如鳥獸散	如鸟兽散	rú niǎo shòu sàn	to scatter like birds and beasts (idiom)/to flee in all directions
妻離子散	妻离子散	qī lí zǐ sàn	a family wrenched apart (idiom)
尼散月	尼散月	Ní sàn yuè	Nisan, the first month of the ecclesiastical year in the Jewish calendar
彌散	弥散	mí sàn	to dissipate everywhere (of light, sound, gas etc)
懶散	懒散	lǎn sǎn	inactive/careless/lazy/indolent/negligent
打散	打散	dǎ sàn	to scatter/to break sth up/to beat (an egg)
披頭散髮	披头散发	pī tóu sàn fà	with dishevelled hair (idiom)/with one's hair down
拆散	拆散	chāi sàn	to break up (a marriage, family etc)
拋散	抛散	pāo sàn	to scatter/to disperse
擴散	扩散	kuò sàn	to spread/to proliferate/to diffuse/spread/proliferation/diffusion
擴散周知	扩散周知	kuò sàn zhōu zhī	to let everyone know/spread the word!
一哄而散	一哄而散	yī hōng ér sàn	to disperse in confusion (idiom)
一拍兩散	一拍两散	yī pāi liǎng sàn	(of marriage or business partners) to break up (idiom)/to separate
散亂	散乱	sàn luàn	in disorder/messy
散亡	散亡	sàn wáng	dispersed and lost
散件	散件	sǎn jiàn	spare parts/odds and ends
散伙	散伙	sàn huǒ	to disband/(of a partnership, group etc) to break up
散伙飯	散伙饭	sàn huǒ fàn	farewell dinner party
散佈	散布	sàn bù	to disseminate
散光	散光	sǎn guāng	astigmatism/see also 散光[sàn guāng]
散光	散光	sàn guāng	to diffuse light/see also 散光[sǎn guāng]
散兵	散兵	sǎn bīng	loose and disorganized soldiers/stragglers/fig. a loner
散兵坑	散兵坑	sǎn bīng kēng	foxhole (military)
散兵遊勇	散兵游勇	sǎn bīng yóu yǒng	lit. straggling and disbanded soldiers (idiom); fig. disorganized uncoordinated action
散出	散出	sàn chū	to spill out
散列	散列	sǎn liè	to hash/hashing (computing)
散劑	散剂	sǎn jì	powder medicine
散匪	散匪	sǎn fěi	scattered bandits/fig. random jottings/marginal notes
散場	散场	sàn chǎng	(of a theater) to empty/(of a show) to end
散失	散失	sàn shī	to squander/lost
散學	散学	sàn xué	end of school
散客	散客	sǎn kè	FIT (free independent traveler)/individual traveler (as opposed to traveling with a group)
散射	散射	sǎn shè	scattering
散居	散居	sǎn jū	(of a group of people) to live scattered over an area
散工	散工	sǎn gōng	day labor/piece-time work
散工	散工	sàn gōng	to release from work at the end of the day
散席	散席	sàn xí	end of a banquet
散座	散座	sǎn zuò	single seat (in theater)/irregular passenger (in rickshaw)
散座兒	散座儿	sǎn zuò r5	erhua variant of 散座[sǎn zuò]/single seat (in theater)/irregular passenger (in rickshaw)
散彈	散弹	sǎn dàn	(gun) shot/canister shot
散彈槍	散弹枪	sǎn dàn qiāng	shotgun
散心	散心	sàn xīn	to drive away cares/to relieve boredom
散心解悶	散心解闷	sàn xīn jiě mèn	to divert one's mind from boredom (idiom)
散悶	散闷	sàn mèn	to divert oneself from melancholy
散戲	散戏	sàn xì	end of a show
散戶	散户	sǎn hù	individual (shareholder)/the small investor
散打	散打	sàn dǎ	mixed martial arts
散播	散播	sàn bō	to spread/to disperse/to disseminate
散攤子	散摊子	sàn tān zi	to break up/to disband
散散步	散散步	sàn sàn bù	to have a stroll
散文	散文	sǎn wén	prose/essay
散文詩	散文诗	sǎn wén shī	prose poem
散景	散景	sǎn jǐng	bokeh (photography)
散曲	散曲	sǎn qǔ	verse or song form from Yuan, Ming and Qing
散會	散会	sàn huì	to disperse a meeting/to adjourn/finished
散束	散束	sàn shù	scattering of bundle (of electrons in vacuum tube)/debunching
散板	散板	sǎn bǎn	to fall apart/opera section in free rhythm
散架	散架	sǎn jià	to fall apart/exhaustion
散步	散步	sàn bù	to take a walk/to go for a walk
散水	散水	sàn shuǐ	apron (sloping brickwork to disperse water)
散沙	散沙	sǎn shā	scattered sand/fig. lacking in cohesion or organization
散漫	散漫	sǎn màn	undisciplined/unorganized
散焦	散焦	sàn jiāo	to defocus/bokeh
散熱	散热	sàn rè	to dissipate heat
散熱器	散热器	sàn rè qì	radiator (for heating a room)/radiator (for cooling an engine)
散熱器護柵	散热器护栅	sàn rè qì hù shān	radiator grille
散熱片	散热片	sàn rè piàn	heat sink
散熱膏	散热膏	sàn rè gāo	thermal grease
散發	散发	sàn fā	to distribute/to emit/to issue
散盡	散尽	sàn jìn	to be totally dispersed (crowd)
散碎	散碎	sǎn suì	in fragments
散粉	散粉	sǎn fěn	loose powder (makeup)
散職	散职	sǎn zhí	sinecure
散腿褲	散腿裤	sǎn tuǐ kù	loose-fitting pants/Chinese-style pants
散落	散落	sàn luò	to disperse/to fall scattered/to sprinkle
散裝	散装	sǎn zhuāng	loose goods/goods sold open/draft (of beer, as opposed to bottled)
散見	散见	sǎn jiàn	seen periodically
散記	散记	sǎn jì	random jottings/travel notes
散話	散话	sǎn huà	digression
散誕	散诞	sǎn dàn	free and unfettered
散逸	散逸	sàn yì	dispersal
散逸層	散逸层	sàn yì céng	exosphere
散錢	散钱	sǎn qián	small sum of money/loose change/Cantonese equivalent of 零錢|零钱[líng qián]
散錢	散钱	sàn qián	to scatter money/to give to charity
散開	散开	sàn kāi	to separate/to disperse
散養	散养	sǎn yǎng	free-range raising (of poultry, cattle etc)
散體	散体	sǎn tǐ	free prose style
散點圖	散点图	sǎn diǎn tú	scatter plot
旅遊集散	旅游集散	lǚ yóu jí sàn	tourism center or hub
果實散播	果实散播	guǒ shí sàn bō	fruit dispersal
核不擴散	核不扩散	hé bù kuò sàn	nuclear nonproliferation
核擴散	核扩散	hé kuò sàn	nuclear proliferation
樹倒猢猻散	树倒猢狲散	shù dǎo hú sūn sàn	When the tree topples the monkeys scatter. (idiom); fig. an opportunist abandons an unfavorable cause/Rats leave a sinking ship.
氣體擴散	气体扩散	qì tǐ kuò sàn	gaseous diffusion
消散	消散	xiāo sàn	to dissipate
渙散	涣散	huàn sàn	to slacken/lax/slack/disorganized
潰散	溃散	kuì sǎn	defeated/routed
無業閑散	无业闲散	wú yè xián sǎn	unemployed and idle
煙消雲散	烟消云散	yān xiāo yún sàn	to vanish like smoke in thin air/to disappear
疏散	疏散	shū sàn	to scatter/to disperse/to evacuate/scattered/to relax
疏散措施	疏散措施	shū sàn cuò shī	evacuation/measures to evacuate a building in an emergency
發散	发散	fā sàn	to disperse/to diverge
盡歡而散	尽欢而散	jìn huān ér sàn	to disperse after a happy time (idiom)/everyone enjoys themselves to the full then party breaks up
緊急疏散	紧急疏散	jǐn jí shū sàn	emergency evacuation
耗散	耗散	hào sàn	to dissipate/to squander
聚散	聚散	jù sàn	coming together and separating/aggregation and dissipation
自由散漫	自由散漫	zì yóu sǎn màn	easy-going/lax/unconstrained/unruly
蒸散	蒸散	zhēng sàn	(plant) evapotranspiration
蓬散	蓬散	péng sǎn	loose/ruffled/disheveled
蓬頭散髮	蓬头散发	péng tóu sàn fà	disheveled
解散	解散	jiě sàn	to dissolve/to disband
走散	走散	zǒu sàn	to wander off/to stray/to get lost
輻射散射	辐射散射	fú shè sàn shè	radiation scattering
逸散	逸散	yì sàn	to vaporize/to dispel
遣散	遣散	qiǎn sàn	to disband/to dismiss/demobilization
閑散	闲散	xián sǎn	idle/unused/at leisure
陰魂不散	阴魂不散	yīn hún bù sàn	lit. the soul of a deceased has not yet dispersed (idiom)/fig. the influence still lingers on/the spirit (of some doctrine) is still alive
集散	集散	jí sàn	to collect for distribution
集散地	集散地	jí sàn dì	distribution center
離散	离散	lí sàn	(of family members) separated from one another/scattered about/dispersed/(math.) discrete
離散性	离散性	lí sàn xìng	discreteness
離散數學	离散数学	lí sàn shù xué	discrete mathematics
雲散風流	云散风流	yún sàn fēng liú	lit. clouds scatter, wind flows (idiom); the crisis settles down/people disperse home/things return to normal
雲消霧散	云消雾散	yún xiāo wù sàn	the clouds melt and the mists disperse (idiom)/to clear up/to vanish into thin air
零散	零散	líng sǎn	scattered
風流雲散	风流云散	fēng liú yún sàn	lit. dispersed by wind and scattered like clouds (idiom); fig. scattered far and wide (of friends and relatives)
飄散	飘散	piāo sàn	to waft (through the air)/to drift
驅散	驱散	qū sàn	to disperse/to break up
鬆散	松散	sōng san	to relax/loose/not consolidated/not rigorous
鬆散物料	松散物料	sōng san wù liào	diffuse medium (liquid or gas)
魂飛魄散	魂飞魄散	hún fēi pò sàn	lit. the soul flies away and scatters (idiom)/fig. to be frightened stiff/spooked out of one's mind/terror-stricken
鳥獸散	鸟兽散	niǎo shòu sàn	to scatter like birds and beasts
