溶	溶	róng	to dissolve/soluble
即溶咖啡	即溶咖啡	jí róng kā fēi	instant coffee
可溶	可溶	kě róng	soluble
可溶性	可溶性	kě róng xìng	solubility
固體溶體	固体溶体	gù tǐ róng tǐ	solid solution
岩溶	岩溶	yán róng	karst, kind of porous limestone (geology)
微溶	微溶	wēi róng	slightly soluble
易溶	易溶	yì róng	soluble
氣溶膠	气溶胶	qì róng jiāo	aerosol
氣溶膠偵察儀	气溶胶侦察仪	qì róng jiāo zhēn chá yí	aerosol detector
水溶	水溶	shuǐ róng	water soluble
水溶性	水溶性	shuǐ róng xìng	soluble (in water)/solubility
淋溶土	淋溶土	Lìn róng tǔ	Argosols (Chinese Soil Taxonomy)
淋溶層	淋溶层	lín róng céng	alluvium (soil deposited by rivers)
不溶	不溶	bù róng	insoluble
溶劑	溶剂	róng jì	solvent
溶化	溶化	róng huà	to melt/to dissolve (of sugar etc)
溶岩流	溶岩流	róng yán liú	lava flow
溶栓	溶栓	róng shuān	thrombolysis (med.)
溶沒	溶没	róng mò	to fade away/to disappear/to hide from view
溶洞	溶洞	róng dòng	karst cave
溶液	溶液	róng yè	solution (chemistry)
溶源性	溶源性	róng yuán xìng	lysogeny (reproduction cycle of bacteriophage 噬菌體|噬菌体[shì jūn tǐ])
溶蝕	溶蚀	róng shí	dissolving/erosion by groundwater/corrosion
溶蝕作用	溶蚀作用	róng shí zuò yòng	dissolving/erosion by groundwater/corrosion
溶血	溶血	róng xuè	hemolysis (breakdown of red blood cells leading to anemia)
溶血病	溶血病	róng xuè bìng	hemolytic disease of newborn (breakdown of red blood cells due to alloimmune reaction between mother and fetus)
溶解	溶解	róng jiě	to dissolve
溶解度	溶解度	róng jiě dù	solubility
溶解性	溶解性	róng jiě xìng	soluble/solubility
溶質	溶质	róng zhì	dissolved substance/material in solution
溶酶儲存疾病	溶酶储存疾病	róng méi chǔ cún jí bìng	lysosomal storage disease (LSD)
溶酶體	溶酶体	róng méi tǐ	lysosome
溶體	溶体	róng tǐ	solution
脫溶	脱溶	tuō róng	to precipitate (solid from a solution)
速溶	速溶	sù róng	quick-dissolving/instantly-ready/instant
速溶咖啡	速溶咖啡	sù róng kā fēi	instant coffee
