哈	哈	Hā	abbr. for 哈薩克斯坦|哈萨克斯坦[Hā sà kè sī tǎn], Kazakhstan/abbr. for 哈爾濱|哈尔滨[Hā ěr bīn], Harbin
哈	哈	hā	(interj.) ha!/(onom. for laughter)/(slang) to be infatuated with/to adore/abbr. for 哈士奇[hā shì qí], husky (dog)
哈	哈	hǎ	a Pekinese/a pug/(dialect) to scold
亨利·哈德遜	亨利·哈德逊	Hēng lì · Hā dé xùn	Henry Hudson (?-1611?), English explorer and navigator
京哈	京哈	Jīng Hā	Beijing-Harbin
京哈鐵路	京哈铁路	Jīng Hā tiě lù	Beijing-Harbin railway
伊犁哈薩克自治州	伊犁哈萨克自治州	Yī lí Hā sà kè zì zhì zhōu	Ili Kazakh autonomous prefecture in Xinjiang
元江哈尼族彞族傣族自治縣	元江哈尼族彝族傣族自治县	Yuán jiāng Hā ní zú Yí zú Dǎi zú Zì zhì xiàn	Yuanjiang Hani, Yi and Dai autonomous county in Yuxi 玉溪[Yù xī], Yunnan
克孜爾尕哈	克孜尔尕哈	Kè zī ěr gǎ hā	Kizilgaha (Uighur: red-mouthed crow or border sentry), site of famous fire beacon tower and cliff caves in Kuchar county 庫車|库车, Aksu 阿克蘇地區|阿克苏地区, Xinjiang
克孜爾尕哈烽火台	克孜尔尕哈烽火台	Kè zī ěr gǎ hā fēng huǒ tái	Kizilgaha fire beacon tower in Kuchar county 庫車|库车, Aksu 阿克蘇地區|阿克苏地区, Xinjiang
公哈	公哈	gōng hā	male husky (dog)
利勒哈默爾	利勒哈默尔	Lì lè hā mò ěr	Lillehammer (city in Norway)
努爾哈赤	努尔哈赤	Nǔ ěr hā chì	Nurhaci (1559-1626), founder and first Khan of the Manchu Later Jin dynasty 後金|后金 (from 1616)
勒哈費爾	勒哈费尔	Lè Hā fèi ěr	Le Havre (French town)
史蒂芬·哈珀	史蒂芬·哈珀	Shǐ dì fēn · Hā pò	see 斯蒂芬·哈珀[Sī dì fēn · Hā pò]
二哈	二哈	èr hā	(coll.) silly but cute husky (dog)
亞哈	亚哈	Yà hā	Ahab (9th c. BC), King of Israel, son of Omri and husband of Jezebel, prominent figure in 1 Kings 16-22
亞哈斯	亚哈斯	Yà hā sī	Ahaz (son of Jotham)
哈伯	哈伯	Hā bó	Edwin Hubble (1889-1953), US astronomer/Fritz Haber (1868-1934), German chemist
哈伯太空望遠鏡	哈伯太空望远镜	Hā bó Tài kōng Wàng yuǎn jìng	Hubble Space Telescope
哈伯瑪斯	哈伯玛斯	Hā bó mǎ sī	Jürgen Habermas (1929-), German social philosopher
哈佛	哈佛	Hā fó	Harvard
哈佛大學	哈佛大学	Hā fó Dà xué	Harvard University
哈倫褲	哈伦裤	hā lún kù	harem pants (loanword)
哈克貝利·芬歷險記	哈克贝利·芬历险记	Hā kè bèi lì · Fēn Lì xiǎn Jì	Adventures of Huckleberry Finn by Mark Twain 馬克·吐溫|马克·吐温[Mǎ kè · Tǔ wēn]
哈利	哈利	Hā lì	Harry
哈利·波特	哈利·波特	Hā lì · Bō tè	Harry Potter, boy wizard in the novels by J.K. Rowling 羅琳|罗琳
哈利伯頓	哈利伯顿	Hā lì bó dùn	Halliburton (US construction company)
哈利法克斯	哈利法克斯	Hā lì fǎ kè sī	Halifax (name)/Halifax city, capital of Nova Scotia, Canada/Halifax, town in West Yorkshire, England
哈利路亞	哈利路亚	hā lì lù yà	hallelujah (loanword)
哈利迪亞	哈利迪亚	Hā lì dí yà	Habbaniyah (Iraqi city)
哈努卡	哈努卡	Hā nǔ kǎ	Hanukkah (Chanukah), 8 day Jewish holiday starting on the 25th day of Kislev (can occur from late Nov up to late Dec on Gregorian calendar)/also called 光明節|光明节 and 哈努卡節|哈努卡节
哈努卡節	哈努卡节	Hā nǔ kǎ jié	Hanukkah (Chanukah), 8 day Jewish holiday starting on the 25th day of Kislev (can occur from late Nov up to late Dec on Gregorian calendar)/also called 光明節|光明节 and simply 哈努卡
哈勃	哈勃	Hā bó	Hubble (name)/Edwin Hubble (1889-1953), US astronomer
哈博羅內	哈博罗内	Hā bó luó nèi	Gaborone, capital of Botswana
哈吉	哈吉	hā jí	haji or hadji (Islam)
哈吉斯	哈吉斯	hā jí sī	haggis (a Scottish dish) (loanword)
哈哈	哈哈	hā hā	(onom.) laughing out loud
哈哈大笑	哈哈大笑	hā hā dà xiào	to laugh heartily/to burst into loud laughter
哈哈笑	哈哈笑	hā hā xiào	to laugh out loud
哈哈鏡	哈哈镜	hā hā jìng	distorting mirror
哈啾	哈啾	hā jiū	achoo (phonetic particle for sneeze)
哈喇	哈喇	hā la	rancid/to kill/to slaughter
哈喇子	哈喇子	hā lá zi	(dialect) saliva
哈嘍	哈喽	hā lóu	hello (loanword)
哈囉	哈啰	hā luō	hello (loanword)
哈囉德	哈罗德	Hā luó dé	Harold, Harald, Harrod (name)/Harrods (department store etc)
哈士奇	哈士奇	hā shì qí	husky (sled dog)
哈士蟆	哈士蟆	hā shì má	Chinese brown frog (Rana chensinensis) (loanword from Manchu)
哈奴曼	哈奴曼	Hā nú màn	Hanuman, a monkey God in the Indian epic Ramayana
哈姆雷特	哈姆雷特	Hā mǔ léi tè	Hamlet (name)/the Tragedy of Hamlet, Prince of Denmark c. 1601 by William Shakespeare 莎士比亞|莎士比亚
哈季奇	哈季奇	Hā jì qí	Goran Hadžić (1958-), Croatian Serb leader until 1994, indicted war criminal
哈密	哈密	Hā mì	Kumul city in Xinjiang (Chinese: Hami)
哈密地區	哈密地区	Hā mì dì qū	Kumul prefecture in Xinjiang
哈密市	哈密市	Hā mì shì	Kumul city in Xinjiang (Chinese: Hami)
哈密瓜	哈密瓜	hā mì guā	Hami melon (a variety of muskmelon)/honeydew melon/cantaloupe
哈尼	哈尼	hā ní	honey (term of endearment) (loanword)
哈尼族	哈尼族	Hā ní zú	Hani ethnic group
哈巴河	哈巴河	Hā bā hé	Habahe county or Qaba nahiyisi in Altay prefecture 阿勒泰地區|阿勒泰地区[Ā lè tài dì qū], Xinjiang
哈巴河縣	哈巴河县	Hā bā hé xiàn	Habahe county or Qaba nahiyisi in Altay prefecture 阿勒泰地區|阿勒泰地区[Ā lè tài dì qū], Xinjiang
哈巴狗	哈巴狗	hǎ bā gǒu	pekingese (dog)/(fig.) sycophant/lackey
哈巴羅夫斯克	哈巴罗夫斯克	Hā bā luó fū sī kè	Khabarovsk, far eastern Russian city and province on the border with Heilongjiang province of China
哈巴谷書	哈巴谷书	Hā bā gǔ shū	Book of Habakkuk
哈巴雪山	哈巴雪山	Hā bā xuě shān	Mt Haba (Nakhi: golden flower), in Lijiang 麗江|丽江, northwest Yunnan
哈布斯堡	哈布斯堡	Hā bù sī bǎo	Hapsburg (European dynasty)
哈希	哈希	hā xī	hash (computing)/see also 散列[sǎn liè]
哈得斯	哈得斯	Hā dé sī	Hades
哈德斯	哈德斯	Hā dé sī	Hades
哈德遜河	哈德逊河	Hā dé xùn Hé	Hudson River, New York State, USA
哈恩	哈恩	Hā ēn	Jaén, Spain
哈扣	哈扣	hā kòu	hardcore (loanword)
哈拉	哈拉	hā lā	to chat idly (Tw)
哈拉子	哈拉子	hā lā zi	(dialect) saliva/also written 哈喇子[hā lá zi]
哈拉爾五世	哈拉尔五世	Hā lā ěr Wǔ shì	Harald V of Norway
哈拉雷	哈拉雷	Hā lā léi	Harare, capital of Zimbabwe
哈拿	哈拿	Hā ná	Hannah (biblical figure)
哈摩辣	哈摩辣	Hā mó là	Gomorrah
哈日	哈日	hā Rì	Japanophile
哈日族	哈日族	hā Rì zú	Japanophile (refers to teenage craze for everything Japanese, originally mainly in Taiwan)
哈普西科德	哈普西科德	hā pǔ xī kē dé	harpsichord
哈根達斯	哈根达斯	Hā gēn Dá sī	Häagen-Dazs
哈桑	哈桑	Hā sāng	Hassan (person name)/Hassan District
哈梅內伊	哈梅内伊	Hā méi nèi yī	Khamenei, Ayatollah Aly (1939-), Supreme Leader of Iran, aka Ali Khamenei
哈棒	哈棒	hā bàng	(slang) (Tw) to give a blowjob
哈欠	哈欠	hā qian	yawn
哈比人	哈比人	Hā bǐ rén	Hobbit/see also 霍比特人[Huò bǐ tè rén]
哈爾斯塔	哈尔斯塔	Hā ěr sī tǎ	Harstad (city in Norway)
哈爾濱	哈尔滨	Hā ěr bīn	Harbin, subprovincial city and capital of Heilongjiang province 黑龍江|黑龙江[Hēi lóng jiāng] in northeast China
哈爾濱工業大學	哈尔滨工业大学	Hā ěr bīn Gōng yè Dà xué	Harbin Institute of Technology
哈爾濱市	哈尔滨市	Hā ěr bīn shì	Harbin, subprovincial city and capital of Heilongjiang province 黑龍江|黑龙江[Hēi lóng jiāng] in northeast China
哈爾登	哈尔登	Hā ěr dēng	Halden (city in Norway)
哈特福德	哈特福德	Hā tè fú dé	Hartford
哈珀	哈珀	Hā pò	Harper (name)/see also 斯蒂芬·哈珀[Sī dì fēn · Hā pò]
哈瓦那	哈瓦那	Hā wǎ nà	Havana, capital of Cuba
哈米吉多頓	哈米吉多顿	Hā mǐ jí duō dùn	Armageddon (in Revelation 16:16)
哈米爾卡	哈米尔卡	Hā mǐ ěr kǎ	Hamilcar (c. 270-228 BC), Carthaginian statesman and general
哈羅	哈罗	hā luó	hello (loanword)
哈腰	哈腰	hā yāo	to bend
哈莉·貝瑞	哈莉·贝瑞	Hā lì · Bèi ruì	Halle Berry (1966-), US actress
哈萊姆	哈莱姆	Hā lái mǔ	Harlem district of Manhattan
哈蒙德	哈蒙德	Hā méng dé	Hammond (surname)
哈薩克	哈萨克	Hā sà kè	Kazakhstan/Kazakh ethnic group in PRC
哈薩克人	哈萨克人	Hā sà kè rén	Kazakh person/Kazakh people
哈薩克文	哈萨克文	Hā sà kè wén	Kazakh written language
哈薩克斯坦	哈萨克斯坦	Hā sà kè sī tǎn	Kazakhstan
哈薩克族	哈萨克族	Hā sà kè zú	Kazakh ethnic group of Xinjiang
哈薩克語	哈萨克语	Hā sà kè yǔ	Kazakh language
哈蘇	哈苏	Hā sū	Hasselblad (camera manufacturer)
哈蜜瓜	哈蜜瓜	hā mì guā	Hami melon (a variety of muskmelon)/honeydew melon/cantaloupe/also written 哈密瓜
哈西納	哈西纳	Hā xī nà	Ms Sheikh Hasina (1947-), Bangladesh politician, prime minister 1996-2001 and from 2009
哈該書	哈该书	Hā gāi shū	Book of Haggai
哈豐角	哈丰角	Hā fēng jiǎo	Cape Ras Hafun, Somalia, the easternmost point in Africa
哈貝爾	哈贝尔	Hā bèi ěr	Habel, Haber or Hubbell (name)/Harbel (town in Liberia)
哈貝馬斯	哈贝马斯	Hā bèi mǎ sī	Jürgen Habermas (1929-), German social philosopher
哈迪	哈迪	Hǎ dí	Hardy or Hardie (name)
哈迪斯	哈迪斯	Hā dí sī	Hades
哈迷	哈迷	Hā mí	Harry Potter fan (slang)
哈達	哈达	hǎ dá	khata (Tibetan or Mongolian ceremonial scarf)
哈里	哈里	Hā lǐ	Harry or Hari (name)
哈里斯堡	哈里斯堡	Hā lǐ sī bǎo	Harrisburg, Pennsylvania
哈里森·施密特	哈里森·施密特	Hā lǐ sēn · Shī mì tè	Harrison Schmitt (Apollo 17 astronaut)
哈里發	哈里发	hā lǐ fā	(loanword) caliph/also written 哈利發|哈利发[hā lì fā]
哈里發塔	哈里发塔	Hā lǐ fā Tǎ	Burj Khalifa, skyscraper in Dubai, 830 m high
哈里發帝國	哈里发帝国	Hā lǐ fā Dì guó	Caliphate (Islamic empire formed after the death of the Prophet Mohammed 穆罕默德 in 632)
哈雷彗星	哈雷彗星	Hā léi Huì xīng	Halley's Comet
哈靈根	哈灵根	hā líng gēn	Harlingen, the Netherlands
哈馬斯	哈马斯	Hā mǎ sī	Hamas (radical Palestinian group)
哈馬爾	哈马尔	Hā mǎ ěr	Hamar (town in Norway)
哈馬黑拉島	哈马黑拉岛	Hā mǎ hēi lā Dǎo	Halmahera, an island of Indonesia
哥本哈根	哥本哈根	Gē běn hā gēn	Copenhagen or København, capital of Denmark
哼兒哈兒	哼儿哈儿	hēng r5 hā r5	to hem and haw (loanword)
嘎拉哈	嘎拉哈	gā lā hà	(Manchu loanword) knucklebones/see 羊拐[yáng guǎi]
嘻哈	嘻哈	xī hā	hip-hop (music genre) (loanword)
噶哈巫族	噶哈巫族	Gá hā wū zú	Kaxabu or Kahabu, one of the indigenous peoples of Taiwan
坎大哈	坎大哈	Kǎn dà hā	Kandahar (town in Southern Afghanistan)
坎大哈省	坎大哈省	Kǎn dà hā shěng	Kandahar province of Afghanistan
埃斯特哈齊	埃斯特哈齐	Āi sī tè hā qí	Esterhazy (name)
塔拉哈西	塔拉哈西	Tǎ lā hā xī	Tallahassee, capital of Florida
墨江哈尼族自治縣	墨江哈尼族自治县	Mò jiāng Hā ní zú Zì zhì xiàn	Mojiang Hani Autonomous County in Pu'er 普洱[Pǔ ěr], Yunnan
多哈	多哈	Duō hā	Doha, capital of Qatar
多哈回合	多哈回合	Duō hā Huí hé	Doha Round (world trade talks that began in Doha, Qatar in 2001)
大馬哈魚	大马哈鱼	dà mǎ hǎ yú	chum salmon
大鱗大馬哈魚	大鳞大马哈鱼	dà lín dá mǎ hǎ yú	see 大鱗大麻哈魚|大鳞大麻哈鱼[dà lín dá má hǎ yú]
大鱗大麻哈魚	大鳞大麻哈鱼	dà lín dá má hǎ yú	king salmon/Chinook salmon
大麻哈魚	大麻哈鱼	dà má hǎ yú	see 大馬哈魚|大马哈鱼[dà mǎ hǎ yú]
奧馬哈	奥马哈	Ào mǎ hā	Omaha
察哈爾	察哈尔	Chá hā ěr	Chahar Province (former province in North China existing from 1912-1936)
察哈爾右翼中旗	察哈尔右翼中旗	Chá hā ěr yòu yì zhōng qí	Chahar Right Center banner or Caxar Baruun Garyn Dund khoshuu in Ulaanchab 烏蘭察布|乌兰察布[Wū lán chá bù], Inner Mongolia
察哈爾右翼前旗	察哈尔右翼前旗	Chá hā ěr yòu yì qián qí	Chahar Right Front banner or Caxar Baruun Garyn Ömnöd khoshuu in Ulaanchab 烏蘭察布|乌兰察布[Wū lán chá bù], Inner Mongolia
察哈爾右翼後旗	察哈尔右翼后旗	Chá hā ěr yòu yì hòu qí	Chahar Right Rear banner or Caxar Baruun Garyn Xoit khoshuu in Ulaanchab 烏蘭察布|乌兰察布[Wū lán chá bù], Inner Mongolia
寧洱哈尼族彞族自治縣	宁洱哈尼族彝族自治县	Níng ěr Hā ní zú Yí zú Zì zhì xiàn	Ning'er Hani and Yi Autonomous County in Yunnan, capital Pu'er city 普洱市[Pǔ ěr shì]/formerly Pu'er Hani and Yi autonomous county
巴哈	巴哈	Bā hā	Johann Sebastian Bach (1685-1750), German composer (Tw)
巴哈伊	巴哈伊	Bā hā yī	Baha'i (religion)
巴哈馬	巴哈马	Bā hā mǎ	The Bahamas
巴里坤哈薩克自治縣	巴里坤哈萨克自治县	Bā lǐ kūn Hā sà kè Zì zhì xiàn	Barkol Kazakh autonomous county or Barköl Qazaq aptonom nahiyisi in Kumul prefecture 哈密地區|哈密地区[Hā mì dì qū], Xinjiang
布哈拉	布哈拉	Bù hā lā	Bokhara or Bukhara city in Uzbekistan
布哈林	布哈林	Bù hā lín	Nikolai Ivanovich Bukharin (1888-1938), Soviet revolutionary theorist, executed after a show trial in 1937
德令哈	德令哈	Dé lìng hā	Delingha city in Haixi Mongol and Tibetan autonomous prefecture 海西蒙古族藏族自治州[Hǎi xī Měng gǔ zú Zàng zú zì zhì zhōu], Qinghai
德令哈市	德令哈市	Dé lìng hā shì	Delingha city in Haixi Mongol and Tibetan autonomous prefecture 海西蒙古族藏族自治州[Hǎi xī Měng gǔ zú Zàng zú zì zhì zhōu], Qinghai
打哈哈	打哈哈	dǎ hā ha	to joke/to laugh insincerely/to make merry/to talk irrelevantly
打哈哈兒	打哈哈儿	dǎ hā ha r5	erhua variant of 打哈哈[dǎ hā ha]
托馬斯·哈代	托马斯·哈代	Tuō mǎ sī · Hā dài	Thomas Hardy (1840-1928), English author
撒哈拉	撒哈拉	Sā hā lā	Sahara
撒哈拉人	撒哈拉人	Sā hā lā rén	Sahrawi (person)
撒哈拉以南	撒哈拉以南	Sā hā lā yǐ nán	sub-Saharan
撒哈拉以南非洲	撒哈拉以南非洲	Sā hā lā yǐ nán Fēi zhōu	sub-Saharan Africa
撒哈拉威	撒哈拉威	Sā hā lā wēi	Sahrawi
撒哈拉沙漠	撒哈拉沙漠	Sǎ hā lā Shā mò	Sahara Desert
斯蒂芬·哈珀	斯蒂芬·哈珀	Sī dì fēn · Hā pò	Stephen Harper (1959-), Canadian politician, prime minister from 2006
普洱哈尼族彞族自治縣	普洱哈尼族彝族自治县	Pǔ ěr Hā ní zú Yí zú Zì zhì xiàn	former Pu'er Hani and Yi autonomous county in Yunnan, renamed in 2007 Ning'er Hani and Yi autonomous county 寧洱哈尼族彞族自治縣|宁洱哈尼族彝族自治县, capital Pu'er city 普洱市
曼哈坦	曼哈坦	Màn hā tǎn	Manhattan island/Manhattan borough of New York City/also written 曼哈頓|曼哈顿
曼哈頓	曼哈顿	Màn hā dùn	Manhattan island/Manhattan borough of New York City
曼哈頓區	曼哈顿区	Màn hā dùn qū	Manhattan borough of New York City
木壘哈薩克自治縣	木垒哈萨克自治县	Mù lěi Hā sà kè Zì zhì xiàn	Mori Kazakh autonomous county or Mori Qazaq aptonom nahiyisi in Changji Hui autonomous prefecture 昌吉回族自治州[Chāng jí Huí zú zì zhì zhōu], Xinjiang
杜哈	杜哈	Dù hā	Doha, capital of Qatar (Tw)
梭哈	梭哈	suō hā	(poker) show hand (loanword)/five-card stud
楠格哈爾省	楠格哈尔省	Nán gé hā ěr shěng	Nangarhar province of Afghanistan
母哈	母哈	mǔ hā	female husky (dog)
比哈爾邦	比哈尔邦	Bǐ hā ěr bāng	Bihar, state in eastern India
江城哈尼族彞族自治縣	江城哈尼族彝族自治县	Jiāng chéng Hā ní zú Yí zú Zì zhì xiàn	Jiangcheng Hani and Yi autonomous county in Pu'er 普洱[Pǔ ěr], Yunnan
泰姬瑪哈陵	泰姬玛哈陵	Tài jī Mǎ hā Líng	Taj Mahal/abbr. to 泰姬陵[Tài jī líng]
烏良哈	乌良哈	Wū liáng hǎ	Mongol surname
瓜達拉哈拉	瓜达拉哈拉	Guā dá lā hā lā	Guadalajara
瓦哈比教派	瓦哈比教派	wǎ hā bǐ jiào pài	Wahhabism (a conservative sect of Islam)
笑哈哈	笑哈哈	xiào hā hā	to laugh heartily
米哈伊爾·普羅霍羅夫	米哈伊尔·普罗霍罗夫	Mǐ hā yī ěr · Pǔ luó huò luó fū	Mikhail Prokhorov (1965-), Russian billionaire and owner of the Brooklyn Nets (NBA team)
紅河哈尼族彞族自治州	红河哈尼族彝族自治州	Hóng hé Hā ní zú Yí zú zì zhì zhōu	Honghe Hani and Yi autonomous prefecture in Yunnan 雲南|云南
索多瑪與哈摩辣	索多玛与哈摩辣	Suǒ duō mǎ yǔ Hā mó là	Sodom and Gomorrah
聖哈辛托	圣哈辛托	Shèng hā xīn tuō	San Jacinto
艾哈邁德	艾哈迈德	Ài hǎ mài dé	Ahmed (name)
艾哈邁迪內賈德	艾哈迈迪内贾德	Ài hā mài dí nèi jiǎ dé	Ahmadinejad or Ahmadinezhad (Persian name)/Mahmoud Ahmadinejad (1956-), Iranian fundamentalist politician, president of Iran 2005-2013
艾哈邁達巴德	艾哈迈达巴德	Ài hā mài dá bā dé	Ahmedabad, largest city in west Indian state Gujarat 古吉拉特[Gǔ jí lā tè]
苦哈哈	苦哈哈	kǔ hā hā	to have difficulty getting by/to struggle (financially etc)
莫哈韋沙漠	莫哈韦沙漠	Mò hā wéi Shā mò	Mojave Desert, southwestern USA
蕾哈娜	蕾哈娜	Lěi hā nà	Rihanna (1988-), Barbadian pop singer
薩哈洛夫	萨哈洛夫	Sà hā luò fū	Sakharov (Russian name)
薩哈羅夫	萨哈罗夫	Sà hǎ luó fū	Andrei Sakharov (1921-1989), Russian nuclear scientist and dissident human rights activist
薩哈羅夫人權獎	萨哈罗夫人权奖	Sà hǎ luó fū Rén quán jiǎng	the EU Sakharov Human Rights Prize
薩哈羅夫獎	萨哈罗夫奖	Sà hǎ luó fū jiǎng	Sakharov Prize for Freedom of Thought (awarded by EU since 1988)
薩哈諾夫	萨哈诺夫	sà hǎ nuò fū	(Andrei) Sakharov
薩哈諾夫人權獎	萨哈诺夫人权奖	sà hǎ nuò fū rén quán jiǎng	the EU Sakharov prize for human rights
蘇哈托	苏哈托	Sū hā tuō	Suharto (1921-2008), former Indonesian general, president of the Republic of Indonesia 1967-1998
西哈努克	西哈努克	Xī hā nǔ kè	(King) Sihanouk (of Cambodia)
西屬撒哈拉	西属撒哈拉	Xī shǔ Sā hā lā	Spanish Sahara (former Spanish colony in Africa)
西撒哈拉	西撒哈拉	Xī Sā hā lā	Western Sahara
費爾巴哈	费尔巴哈	Fèi ěr bā hā	Ludwig Feuerbach (1804-1872), materialist philosopher
辣哈布	辣哈布	Lā hā bù	Rahab (name)
逗哈哈	逗哈哈	dòu hā hā	to joke/to crack a joke
鎮沅彞族哈尼族拉祜族自治縣	镇沅彝族哈尼族拉祜族自治县	Zhèn yuán Yí zú Hā ní zú Lā hù zú Zì zhì xiàn	Zhenyuan Yi, Hani and Lahu autonomous county in Pu'er 普洱[Pǔ ěr], Yunnan
阿什哈巴德	阿什哈巴德	Ā shén hā bā dé	Ashgabat, capital of Turkmenistan
阿什哈巴特	阿什哈巴特	Ā shí hā bā tè	Ashgabat, capital of Turkmenistan (Tw)
阿克塞哈薩克族自治縣	阿克塞哈萨克族自治县	Ā kè sài Hā sà kè zú Zì zhì xiàn	Aksai Kazakh autonomous county in Jiuquan 酒泉, Gansu
阿姆哈拉	阿姆哈拉	Ā mǔ hā lā	Amhara (province, language and ethnic group of Ethiopia)/Amharic/Ethiopian
阿布哈茲	阿布哈兹	Ā bù hā zī	Abkhazia, region in Georgia
雅馬哈	雅马哈	Yǎ mǎ hā	Yamaha
馬哈拉施特拉邦	马哈拉施特拉邦	Mǎ hā lā shī tè lā bāng	Maharashtra (state in India)
馬哈迪	马哈迪	Mǎ hā dí	Mahathir bin Mohamad (1925-), Malaysian politician, prime minister 1981-2003 and 2018-
馬大哈	马大哈	mǎ dà hā	a careless person/scatterbrain/frivolous and forgetful/abbr. for 馬馬虎虎、大大咧咧、嘻嘻哈哈|马马虎虎、大大咧咧、嘻嘻哈哈
點頭哈腰	点头哈腰	diǎn tóu hā yāo	to nod one's head and bow (idiom); bowing and scraping/unctuous fawning
齊齊哈爾	齐齐哈尔	Qí qí hā ěr	Qiqihar prefecture level city in Heilongjiang province 黑龍江|黑龙江[Hēi lóng jiāng] in northeast China
齊齊哈爾市	齐齐哈尔市	Qí qí hā ěr shì	Qiqihar prefecture level city in Heilongjiang province 黑龍江|黑龙江[Hēi lóng jiāng] in northeast China
