找	找	zhǎo	to try to find/to look for/to call on sb/to find/to seek/to return/to give change
尋找	寻找	xún zhǎo	to seek/to look for
不用找	不用找	bù yòng zhǎo	"keep the change" (restaurant expression)
找上門	找上门	zhǎo shàng mén	to come to sb's door/to call on sb
找不到	找不到	zhǎo bu dào	can't find
找不自在	找不自在	zhǎo bù zì zai	to ask for trouble/to bring misfortune on oneself
找不著	找不着	zhǎo bu zháo	to be unable to find
找不著北	找不着北	zhǎo bu zháo běi	to be confused and disoriented
找事	找事	zhǎo shì	to look for employment/to pick a quarrel
找借口	找借口	zhǎo jiè kǒu	to look for a pretext
找出	找出	zhǎo chū	to find/to search out
找到	找到	zhǎo dào	to find
找刺兒	找刺儿	zhǎo cì r5	to find fault
找台階兒	找台阶儿	zhǎo tái jiē r5	to find an excuse/to look for a pretext
找回	找回	zhǎo huí	to retrieve
找尋	找寻	zhǎo xún	to look for/to seek/to find fault
找對象	找对象	zhǎo duì xiàng	to seek a marriage partner/looking for a mate
找岔子	找岔子	zhǎo chà zi	to look for blemishes/to find fault/nitpicking
找平	找平	zhǎo píng	to level (ground)/to make level
找抽	找抽	zhǎo chōu	(coll.) to look for trouble
找機會	找机会	zhǎo jī huì	to look for an opportunity
找死	找死	zhǎo sǐ	to court death/taking risks
找碴	找碴	zhǎo chá	variant of 找茬[zhǎo chá]
找碴兒	找碴儿	zhǎo chá r5	to pick a quarrel/to find fault/nitpicking
找茬	找茬	zhǎo chá	to pick fault with/to spot the differences/to nitpick/to pick a quarrel/to find complaint with
找著	找着	zhǎo zháo	to find
找補	找补	zhǎo bu	to compensate/to make up/to complement/to add
找見	找见	zhǎo jiàn	to find (sth one has been looking for)
找贖	找赎	zhǎo shú	(dialect) to give change
找轍	找辙	zhǎo zhé	to look for a pretext
找遍	找遍	zhǎo biàn	to search everywhere/to search high and low/to comb
找錢	找钱	zhǎo qián	to give change
找門路	找门路	zhǎo mén lù	to seek help from social connections
找零	找零	zhǎo líng	to give change/change money
找頭	找头	zhǎo tou	change (from money paid)
找飯碗	找饭碗	zhǎo fàn wǎn	to look for a job
找麻煩	找麻烦	zhǎo má fan	to look for trouble
找齊	找齐	zhǎo qí	to make uniform/to even up/to make good a deficiency
查找	查找	chá zhǎo	to search for/to look up
滿地找牙	满地找牙	mǎn dì zhǎo yá	to be looking for one's teeth all over the floor/(fig.) to get beaten up badly/to beat the crap out of (sb)
自找	自找	zì zhǎo	to suffer as a consequence of one's own actions/you asked for it/to bring it on oneself (sth unpleasant)
自找苦吃	自找苦吃	zì zhǎo kǔ chī	to bring trouble on oneself
自找麻煩	自找麻烦	zì zhǎo má fan	to ask for trouble/to invite difficulties
花錢找罪受	花钱找罪受	huā qián zhǎo zuì shòu	to spend money on sth that turns out to be unsatisfactory or even disastrous
騎驢找驢	骑驴找驴	qí lǘ zhǎo lǘ	lit. to search for the mule while riding on it (idiom)/fig. to look for what one already has
