氏	氏	shì	clan name/maiden name
氏	氏	zhī	see 月氏[Yuè zhī] and 閼氏|阏氏[yān zhī]
亨氏	亨氏	Hēng shì	Heinz (name)/Heinz, US food processing company
人氏	人氏	rén shì	native/person from a particular place
伏羲氏	伏羲氏	Fú Xī shì	Fuxi or Fu Hsi, legendary Chinese emperor 2852-2738 BC, mythical creator of fishing, trapping, and writing
休氏旋木雀	休氏旋木雀	Xiū shì xuán mù què	(bird species of China) Hume's treecreeper (Certhia manipurensis)
休氏樹鶯	休氏树莺	Xiū shì shù yīng	(bird species of China) Hume's bush warbler (Horornis brunnescens)
休氏白喉林鶯	休氏白喉林莺	Xiū shì bái hóu lín yīng	(bird species of China) Hume's whitethroat (Sylvia althaea)
傷寒沙門氏菌	伤寒沙门氏菌	shāng hán shā mén shì jūn	salmonella typhimurium
元氏	元氏	Yuán shì	Yuanshi county in Shijiazhuang 石家莊|石家庄[Shí jiā zhuāng], Hebei
元氏縣	元氏县	Yuán shì xiàn	Yuanshi county in Shijiazhuang 石家莊|石家庄[Shí jiā zhuāng], Hebei
克隆氏病	克隆氏病	Kè lóng shì bìng	Crohn's disease
克雅氏症	克雅氏症	Kè Yǎ shì zhèng	Creutzfeldt-Jacob disease CJD
克雷伯氏菌屬	克雷伯氏菌属	Kè léi bó shì jūn shǔ	Klebsiella
列氏溫標	列氏温标	liè shì wēn biāo	Réaumur temperature scale
包柔氏螺旋體	包柔氏螺旋体	Bāo róu shì luó xuán tǐ	Borrelia, genus of Spirochaete bacteria
包氏螺旋體	包氏螺旋体	Bāo shì luó xuán tǐ	Borrelia, genus of Spirochaete bacteria
卡波西氏肉瘤	卡波西氏肉瘤	Kǎ bō xī shì ròu liú	Kaposi's sarcoma
史氏蝗鶯	史氏蝗莺	Shǐ shì huáng yīng	(bird species of China) Styan's grasshopper warbler (Locustella pleskei)
吉伯特氏症候群	吉伯特氏症候群	Jí bó tè shì zhèng hòu qún	Gilbert's syndrome
呂氏春秋	吕氏春秋	Lǚ shì Chūn qiū	lit. “Mr. Lü's Spring and Autumn (Annals)”, compendium of the philosophies of the Hundred Schools of Thought 諸子百家|诸子百家[zhū zǐ bǎi jiā], compiled around 239 BC under the patronage of Qin Dynasty 秦代[Qín dài] Chancellor Lü Buwei 呂不韋|吕不韦[Lǚ Bù wéi]
唐氏兒	唐氏儿	táng shì ér	Down's syndrome child
唐氏症	唐氏症	Táng shì zhèng	Down's syndrome/mongolism
唐氏綜合症	唐氏综合症	Táng shì zōng hé zhèng	Down syndrome
圖雷特氏綜合症	图雷特氏综合症	Tú léi tè shì zōng hé zhèng	Tourette syndrome
土拉弗氏菌	土拉弗氏菌	tǔ lā fú shì jūn	Francisella tularensis
大月氏	大月氏	Dà Yuè zhī	the Greater Yuezhi, a branch of the Yuezhi 月氏[Yuè zhī] people of central Asia during the Han dynasty
女媧氏	女娲氏	Nǚ wā shì	Nüwa (creator of humans in Chinese mythology)
姓氏	姓氏	xìng shì	family name
威氏註音法	威氏注音法	Wēi shì zhù yīn fǎ	Wade-Giles transliteration scheme for Chinese
家樂氏	家乐氏	Jiā lè shì	Kellogg's (US food manufacturing company)
尉氏	尉氏	Wèi shì	Weishi county in Kaifeng 開封|开封[Kāi fēng], Henan
尉氏縣	尉氏县	Wèi shì xiàn	Weishi county in Kaifeng 開封|开封[Kāi fēng], Henan
左氏春秋	左氏春秋	Zuǒ shì Chūn qiū	Mr Zuo's Spring and Autumn Annals, attributed to famous blind historian Zuo Qiuming 左丘明[Zuǒ Qiū míng]/usually called Zuo Zhuan 左傳|左传[Zuǒ Zhuàn]
巴氏	巴氏	Bā shì	Pasteur
巴氏殺菌	巴氏杀菌	Bā shì shā jūn	pasteurization
巴氏試驗	巴氏试验	Bā shì shì yàn	Pap test (medicine)
巴金森氏症	巴金森氏症	Bā jīn sēn shì zhèng	Parkinson's disease
布氏桿菌病	布氏杆菌病	bù shì gǎn jūn bìng	brucellosis (undulant fever or Mediterranean fever)
布氏菌苗	布氏菌苗	bù shì jūn miáo	Brucella vaccine
布氏葦鶯	布氏苇莺	Bù shì wěi yīng	(bird species of China) Blyth's reed warbler (Acrocephalus dumetorum)
布氏非鯽	布氏非鲫	bù shì fēi jì	zebra tilapia/Tilapia buttikoferi (zoology)
布萊氏鷚	布莱氏鹨	Bù lái shì liù	(bird species of China) Blyth's pipit (Anthus godlewskii)
布魯氏菌病	布鲁氏菌病	Bù lǔ shì jūn bìng	Brucella (infectious disease)
庖犧氏	庖牺氏	Páo xī shì	another name for 伏羲[Fú Xī], consort of 女媧|女娲[Nǚ wā]
弗氏鷗	弗氏鸥	Fú shì ōu	(bird species of China) Franklin's gull (Leucophaeus pipixcan)
志賀氏菌病	志贺氏菌病	zhì hè shì jūn bìng	shigellosis/bacillary dysentery
懷氏虎鶇	怀氏虎鸫	Huái shì hǔ dōng	(bird species of China) White's thrush (Zoothera aurea)
戈氏岩鵐	戈氏岩鹀	Gē shì yán wú	(bird species of China) Godlewski's bunting (Emberiza godlewskii)
戈氏金絲燕	戈氏金丝燕	Gē shì jīn sī yàn	(bird species of China) Germain's swiftlet (Aerodramus germani)
攝氏	摄氏	Shè shì	Celsius/centigrade
攝氏度	摄氏度	Shè shì dù	°C (degrees Celsius)
旁氏	旁氏	Páng shì	Pond's (brand of skin care products)
春秋左氏傳	春秋左氏传	Chūn qiū Zuǒ shì Zhuàn	Mr Zuo's Spring and Autumn Annals, attributed to famous blind historian Zuo Qiuming 左丘明[Zuǒ Qiū míng]/usually called Zuo Zhuan 左傳|左传[Zuǒ Zhuàn]
普氏	普氏	Pǔ shì	Nikolai Mikhailovich Przevalski 普爾熱瓦爾斯基|普尔热瓦尔斯基 (1839-1888), Russian explorer who made four expeditions to Central Asian from 1870
普氏小羚羊	普氏小羚羊	Pǔ shì xiǎo líng yáng	Przevalski's gazelle (Procapra przewalskii) of Central Asia
普氏立克次體	普氏立克次体	pǔ shì lì kè cì tǐ	Rickettsia prowazekii
普氏野馬	普氏野马	Pǔ shì yě mǎ	Przevalski horse (Equus przewalskii) wild horse of Central Asia first identified in 1881 by Nikolai Mikhailovich Przevalski 普爾熱瓦爾斯基|普尔热瓦尔斯基
月氏	月氏	Yuè zhī	ancient people of central Asia during the Han dynasty
李斯特氏桿菌	李斯特氏杆菌	Lǐ sī tè shì gǎn jūn	listeria bacillus
李斯特氏菌	李斯特氏菌	Lǐ sī tè shì jūn	listeria bacillus
李氏	李氏	Lǐ shì	the Korean Yi or Lee Dynasty (1392-1910)
李氏朝鮮	李氏朝鲜	Lǐ shì Cháo xiǎn	Joseon, last Korean dynasty (1392-1910)
杜氏腺	杜氏腺	Dù shì xiàn	Dufour gland (produces female sex hormone in bees)
杜氏腺體	杜氏腺体	Dù shì xiàn tǐ	Dufour gland (produces female sex hormone in bees)
格蘭氏陰性	格兰氏阴性	gé lán shì yīn xìng	Gram negative (of bacteria)/also written 革蘭氏陰性|革兰氏阴性
格雷氏解剖學	格雷氏解剖学	Gé léi Shì Jiě pōu xué	Gray's Anatomy (medical reference book)
梅氏	梅氏	Méi shì	Charles Messier (1730-1817), French astronomer who catalogued nebulas and galaxies
梅氏腺	梅氏腺	Méi shì xiàn	Mehlis gland
梯氏鶇	梯氏鸫	Tī shì dōng	(bird species of China) Tickell's thrush (Turdus unicolor)
歐氏	欧氏	Ōu shì	Euclid/abbr. for 歐幾里得|欧几里得
歐氏幾何學	欧氏几何学	Ōu shì jǐ hé xué	Euclidean geometry
段氏	段氏	Duàn shì	a branch of the Xianbei 鮮卑|鲜卑 nomadic people
比氏鶲鶯	比氏鹟莺	Bǐ shì wēng yīng	(bird species of China) Bianchi's warbler (Seicercus valentini)
亞伯氏症	亚伯氏症	Yà bó shì zhèng	Apert syndrome
亞氏保加	亚氏保加	Yà shì bǎo jiā	see 阿斯佩爾格爾|阿斯佩尔格尔[Ā sī pèi ěr gé ěr]
氏族	氏族	shì zú	clan
沙門氏菌	沙门氏菌	shā mén shì jūn	Salmonella
源氏物語	源氏物语	Yuán shì Wù yǔ	The Tale of Genji/Genji Monogatari
無名氏	无名氏	wú míng shì	anonymous (e.g. author, donor etc)
燧人氏	燧人氏	Suì rén shì	Suirenshi, legendary inventor of fire
瑞氏染料	瑞氏染料	ruì shì rǎn liào	Wright's stain (used in studying blood)
瑞氏染色	瑞氏染色	ruì shì rǎn sè	Wright's stain (used in studying blood)
盤古氏	盘古氏	Pán gǔ shì	Pangu (creator of the universe in Chinese mythology)
盧氏	卢氏	Lú shì	Lushi county in Sanmenxia 三門峽|三门峡[Sān mén xiá], Henan
盧氏縣	卢氏县	Lú shì xiàn	Lushi county in Sanmenxia 三門峽|三门峡[Sān mén xiá], Henan
神農氏	神农氏	Shén nóng shì	Shennong or Farmer God (c. 2000 BC), first of the legendary Flame Emperors, 炎帝[Yán dì] and creator of agriculture in China/followers or clan of Shennong 神農|神农[Shén nóng]
立氏立克次體	立氏立克次体	lì shì lì kè cì tǐ	Rickettsia rickettsii
簡氏防務週刊	简氏防务周刊	Jiǎn shì fáng wù zhōu kān	Jane's defense weekly
維氏	维氏	Wéi shì	Victorinox (knife manufacturer)
羅氏	罗氏	Luó shì	Roche/F. Hoffmann-La Roche Ltd
羅氏幾何	罗氏几何	Luó shì jǐ hé	hyperbolic geometry/Lobachevskian geometry
羅氏線圈	罗氏线圈	Luó shì xiàn quān	Rogowski coil
美尼爾氏綜合症	美尼尔氏综合症	Měi ní ěr shì zōng hé zhèng	Meniere's disease (loss of balance after stroke)
肺炎克雷伯氏菌	肺炎克雷伯氏菌	fèi yán Kè léi bó shì jūn	Klebsiella pnenmoniae
芮氏	芮氏	Ruì shì	Richter (scale)/Richter (name)
芮氏規模	芮氏规模	Ruì shì guī mó	Richter scale
范氏起電機	范氏起电机	Fàn shì qǐ diàn jī	Van de Graaff generator
華氏	华氏	Huá shì	Fahrenheit
華氏度	华氏度	Huá shì dù	degrees Fahrenheit
衛氏朝鮮	卫氏朝鲜	Wèi shì Cháo xiǎn	Wiman Korea (195-108 BC), historical kingdom in Manchuria, Liaoning and North Korea
裘馨氏肌肉萎縮症	裘馨氏肌肉萎缩症	qiú xīn shì jī ròu wēi suō zhèng	Duchenne muscular dystrophy
譜氏	谱氏	pǔ shì	family tree/ancestral records
變異型克雅氏症	变异型克雅氏症	biàn yì xíng Kè Yǎ shì zhèng	variant Creutzfeldt-Jacobs disease, vCJD
賽氏籬鶯	赛氏篱莺	Sài shì lí yīng	(bird species of China) Sykes's warbler (Iduna rama)
赫氏角鷹	赫氏角鹰	Hè shì jué yīng	see 鷹鵰|鹰雕[yīng diāo]
軒轅氏	轩辕氏	Xuān yuán shì	alternative name for the Yellow Emperor 黃帝|黄帝
郎格罕氏島	郎格罕氏岛	Láng gé hǎn shì dǎo	islets of Langerhans (medicine)
里氏	里氏	Lǐ shì	Richter (scale)
里氏震級	里氏震级	Lǐ shì zhèn jí	Richter magnitude scale
金氏	金氏	Jīn shì	Guinness (name) (Tw)
閼氏	阏氏	yān zhī	formal wife of a Xiongnu chief during the Han Dynasty (206 BC-220 AD)
阿爾茨海默氏病	阿尔茨海默氏病	Ā ěr cí hǎi mò shì bìng	Alzheimer's disease/senile dementia
阿爾茨海默氏症	阿尔茨海默氏症	Ā ěr cí hǎi mò shì zhèng	Alzheimer's disease/senile dementia
阿狄森氏病	阿狄森氏病	Ā dí sēn shì bìng	Addison's disease
阿耳茨海默氏病	阿耳茨海默氏病	Ā ěr cí hǎi mò shì bìng	Alzheimer's disease
霍氏旋木雀	霍氏旋木雀	Huò shì xuán mù què	(bird species of China) Hodgson's treecreeper (Certhia hodgsoni)
霍氏鷹鵑	霍氏鹰鹃	Huò shì yīng juān	(bird species of China) Hodgson's hawk-cuckoo (Hierococcyx nisicolor)
革蘭氏	革兰氏	Gé lán shì	Mr Gram/Dr. Hans Christian Jaochim Gram (1953-1938), Danish doctor and inventor of the Gram stain 革蘭氏染色法|革兰氏染色法
革蘭氏染色法	革兰氏染色法	Gé lán shì rǎn sè fǎ	Gram stain (used to distinguished two different kinds of bacteria)
革蘭氏陰性	革兰氏阴性	Gé lán shì yīn xìng	Gram negative (bacteria that do not retain Gram stain, often the more dangerous kind)
韋氏拼法	韦氏拼法	Wéi shì pīn fǎ	Wade-Giles system (romanization of Chinese)
韋氏鶲鶯	韦氏鹟莺	Wéi shì wēng yīng	(bird species of China) Whistler's warbler (Seicercus whistleri)
馬氏珍珠貝	马氏珍珠贝	mǎ shì zhēn zhū bèi	pearl oyster (genus Pinctada)
馬氏管	马氏管	Mǎ shì guǎn	Malpighian tubule system (in the insect digestive tract etc)
高辛氏	高辛氏	Gāo xīn shì	one of the five legendary emperors, also called 嚳|喾
麥氏賊鷗	麦氏贼鸥	Mài shì zéi ōu	(bird species of China) South Polar skua (Stercorarius maccormicki)
龐氏	庞氏	Páng shì	Ponzi (name)/Pond's (brand of skin care products), also written 旁氏
龐氏騙局	庞氏骗局	Páng shì piàn jú	Ponzi scheme
