聲	声	shēng	sound/voice/tone/noise/reputation/classifier for sounds
一聲	一声	yī shēng	first tone in Mandarin (high, level tone)
一聲不吭	一声不吭	yī shēng bù kēng	to not say a word
一聲不響	一声不响	yī shēng bù xiǎng	to keep totally silent/noiselessly
一遞一聲	一递一声	yī dì yī shēng	(of singers etc) one answering the other
七聲	七声	qī shēng	tones of the musical scale
七聲音階	七声音阶	qī shēng yīn jiē	heptatonic scale
上聲	上声	shǎng shēng	falling and rising tone/third tone in modern Mandarin
不做聲	不做声	bù zuò shēng	keep silent/not say a word
不動聲色	不动声色	bù dòng shēng sè	not a word or movement (idiom); remaining calm and collected/not batting an eyelid
不聲不響	不声不响	bù shēng bù xiǎng	wordless and silent (idiom); without speaking/taciturn
不露聲色	不露声色	bù lù shēng sè	not show one's feeling or intentions
中國好聲音	中国好声音	Zhōng guó Hǎo Shēng yīn	The Voice of China, PRC reality talent show
中聲	中声	zhōng shēng	medial (i.e. middle vowel of a syllable in Asian phonetics)
九聲六調	九声六调	jiǔ shēng liù diào	nine tones and six modes (tonal system of Cantonese and other southern languages)
二聲	二声	èr shēng	second tone
五聲音階	五声音阶	wǔ shēng yīn jiē	pentatonic scale
人聲鼎沸	人声鼎沸	rén shēng dǐng fèi	lit. a boiling cauldron of voices (idiom)/hubbub/brouhaha
仄聲	仄声	zè shēng	oblique tone/nonlevel tone/uneven tone (the third tone of Classical Chinese)
低聲	低声	dī shēng	in a low voice/softly
低聲細語	低声细语	dī shēng xì yǔ	in a whisper/in a low voice (idiom)
促聲	促声	cù shēng	same as 入聲|入声[rù shēng]/entering tone
俞正聲	俞正声	Yú Zhèng shēng	Yu Zhengsheng (1945-), PRC politician
倒彩聲	倒彩声	dào cǎi shēng	jeering/booing/catcalls
倪柝聲	倪柝声	Ní Tuò shēng	Ni Tuosheng or Watchman Nee (1903-1972), influential Chinese Christian
假聲	假声	jiǎ shēng	falsetto/opposite: natural or true voice 真聲|真声[zhēn shēng]
做聲	做声	zuò shēng	to speak/to emit sound
傳聲	传声	chuán shēng	microphone/to use a microphone
傳聲器	传声器	chuán shēng qì	microphone
傳聲筒	传声筒	chuán shēng tǒng	loudhailer/megaphone/one who parrots sb/mouthpiece
先聲	先声	xiān shēng	herald/precursor/harbinger
先聲奪人	先声夺人	xiān shēng duó rén	to gain the upper hand by a show of strength
免責聲明	免责声明	miǎn zé shēng míng	disclaimer
入聲	入声	rù shēng	entering tone/checked tone/one of the four tones of Middle Chinese
八聲杜鵑	八声杜鹃	bā shēng dù juān	(bird species of China) plaintive cuckoo (Cacomantis merulinus)
出聲	出声	chū shēng	to utter/to give voice
初聲	初声	chū shēng	initial (i.e. initial consonant of a syllable in Asian phonetics)
原聲	原声	yuán shēng	acoustic (musical instrument)
厲聲	厉声	lì shēng	stern voice
去聲	去声	qù shēng	falling tone/fourth tone in modern Mandarin
口口聲聲	口口声声	kǒu kou shēng shēng	to keep on saying (idiom); to repeat over and over again
叫聲	叫声	jiào shēng	yelling (sound made by person)/barking/braying/roaring (sound made by animals)
叮噹聲	叮当声	dīng dāng shēng	tinkle
同聲一哭	同声一哭	tóng shēng yī kū	to share one's feeling of grief with others (idiom)
同聲傳譯	同声传译	tóng shēng chuán yì	simultaneous interpretation
同聲翻譯	同声翻译	tóng shēng fān yì	simultaneous translation
名聲	名声	míng shēng	reputation
吞聲	吞声	tūn shēng	to swallow one's cries
吞聲忍氣	吞声忍气	tūn shēng rěn qì	see 忍氣吞聲|忍气吞声[rěn qì tūn shēng]
吭聲	吭声	kēng shēng	to utter a word
吱吱聲	吱吱声	zī zī shēng	squeak
吱聲	吱声	zhī shēng	to utter a word/to make a sound/to cheep/to squeak/also pr. [zī shēng]
吵鬧聲	吵闹声	chǎo nào shēng	noise
吸聲	吸声	xī shēng	sound absorption
吼聲	吼声	hǒu shēng	roar
呼叫聲	呼叫声	hū jiào shēng	whoop
呼呼聲	呼呼声	hū hū shēng	whir
呼聲	呼声	hū shēng	a shout/fig. opinion or demand, esp. expressed by a group
和聲	和声	hé shēng	harmony (music)
咔噠聲	咔哒声	kǎ da shēng	(onom.) clunk
哨子聲	哨子声	shào zi shēng	whistling sound
哭聲	哭声	kū shēng	sound of weeping
哭聲震天	哭声震天	kū shēng zhèn tiān	lit. cries of grief shake the heavens/great sorrow (idiom)
哼聲	哼声	hēng shēng	hum
唉聲嘆氣	唉声叹气	āi shēng tàn qì	sighing voice, wailing breath (idiom)/to heave deep sighs/to sigh in despair
啼聲	啼声	tí shēng	ululation/to howl
喊聲	喊声	hǎn shēng	to yell/hubbub
單口相聲	单口相声	dān kǒu xiàng shēng	comic monologue/one-person comic sketch
嗡嗡聲	嗡嗡声	wēng wēng shēng	hum/drone/buzz
嘈雜聲	嘈杂声	cáo zá shēng	noise/din
嘩啦一聲	哗啦一声	huā lā yī shēng	with a crash/with a thunderous noise
嘶啞聲	嘶哑声	sī yǎ shēng	hoarse
嘶嘶聲	嘶嘶声	sī sī shēng	hiss
噓聲	嘘声	xū shēng	hissing sound/to hiss (as a sign of displeasure)
噝噝聲	咝咝声	sī sī shēng	hissing sound (onom.)
噤聲令	噤声令	jìn shēng lìng	gag order
噪聲	噪声	zào shēng	noise
噪聲污染	噪声污染	zào shēng wū rǎn	noise pollution
四聲	四声	sì shēng	the four tones of Middle Chinese: level tone 平聲|平声, rising tone 上聲|上声, departing tone 去聲|去声 and entering tone 入聲|入声/the four tones of Modern Standard Mandarin
四聲杜鵑	四声杜鹃	sì shēng dù juān	(bird species of China) Indian cuckoo (Cuculus micropterus)
回聲	回声	huí shēng	echo
回聲定位	回声定位	huí shēng dìng wèi	echolocation
大張聲勢	大张声势	dà zhāng shēng shì	to spread one's voice wide (idiom); wide publicity
大放悲聲	大放悲声	dà fàng bēi shēng	to wail loudly and mournfully (idiom)
大聲	大声	dà shēng	loud voice/in a loud voice/loudly
大聲喊叫	大声喊叫	dà shēng hǎn jiào	to shout loudly
大聲疾呼	大声疾呼	dà shēng jí hū	to call loudly (idiom); to get people's attention/to make one's views known
失聲	失声	shī shēng	to lose one's voice/(to cry out) involuntarily
射頻噪聲	射频噪声	shè pín zào shēng	radio frequency noise
對口相聲	对口相声	duì kǒu xiàng shēng	comic crosstalk/formalized comic dialogue between two stand-up comics: funny man 逗哏[dòu gén] and straight man 捧哏[pěng gén]
小聲	小声	xiǎo shēng	in a low voice/(speak) in whispers
尖聲啼哭	尖声啼哭	jiān shēng tí kū	squeal
尾聲	尾声	wěi shēng	coda/epilogue/end
平聲	平声	píng shēng	level or even tone/first and second tones in modern Mandarin
形聲	形声	xíng shēng	ideogram plus phonetic (one of the Six Methods 六書|六书 of forming Chinese characters)/also known as phonogram, phonetic compound or picto-phonetic character
形聲字	形声字	xíng shēng zì	phono-semantic compound character
德國之聲	德国之声	Dé guó zhī Shēng	Deutsche Welle, German publicly-operated international broadcaster
心聲	心声	xīn shēng	thoughts/feelings/aspirations/heartfelt wishes/inner voice
忍氣吞聲	忍气吞声	rěn qì tūn shēng	to submit to humiliation (idiom); to suffer in silence/to swallow one's anger/to grin and bear it
怨聲	怨声	yuàn shēng	wail/lament/voice of complaint
怨聲載道	怨声载道	yuàn shēng zài dào	lit. cries of complaint fill the roads (idiom); complaints rise all around/discontent is openly voiced
怪聲怪氣	怪声怪气	guài shēng guài qì	strange voice/affected manner of speaking
怯聲怯氣	怯声怯气	qiè shēng qiè qì	to speak in a frightened voice that lacks courage (idiom)
悄無聲息	悄无声息	qiǎo wú shēng xī	quietly/noiselessly
悄然無聲	悄然无声	qiǎo rán wú shēng	absolutely quiet
悄聲	悄声	qiǎo shēng	quietly/in a low voice
悲聲載道	悲声载道	bēi shēng zài dào	lamentations fill the roads (idiom); severe suffering all around
悶聲不響	闷声不响	mēn shēng bù xiǎng	to keep silent
悶聲悶氣	闷声闷气	mēn shēng mēn qì	muffled
悶聲發大財	闷声发大财	mēn shēng fā dà cái	to amass wealth while keeping a low profile (idiom)
惡聲	恶声	è shēng	malicious abuse/lewd song/evil reputation
應聲	应声	yìng shēng	an answering voice/to answer a voice/to respond/to copy a voice/to parrot
應聲蟲	应声虫	yīng shēng chóng	yes-man/opinionless person
押平聲韻	押平声韵	yā píng shēng yùn	to restrict to even tone (i.e. final rhyming syllable must be classical first or second tone 平聲|平声)
掌聲	掌声	zhǎng shēng	applause/CL:陣|阵[zhèn]
掌聲雷動	掌声雷动	zhǎng shēng léi dòng	thunderous applause (idiom)
揚聲器	扬声器	yáng shēng qì	speaker
擬聲	拟声	nǐ shēng	onomatopoeia
擬聲唱法	拟声唱法	nǐ shēng chàng fǎ	scat singing
擬聲詞	拟声词	nǐ shēng cí	onomatopoeia
擲地有聲	掷地有声	zhì dì yǒu shēng	lit. if thrown on the floor, it will make a sound (idiom)/fig. (of one's words) powerful and resonating/to have substance
收聲	收声	shōu shēng	(Cantonese) to stop talking/to shut up
放聲	放声	fàng shēng	very loudly/at the top of one's voice
放聲大哭	放声大哭	fàng shēng dà kū	to burst into tears/to sob loudly/to bawl
整聲	整声	zhěng shēng	to tune (a musical instrument)/to regulate the sound
有聲書	有声书	yǒu shēng shū	audiobook
有聲有色	有声有色	yǒu shēng yǒu sè	having sound and color (idiom); vivid/dazzling
有聲讀物	有声读物	yǒu shēng dú wù	audiobook/recording of a person reading the text of a book
槍聲	枪声	qiāng shēng	crack/shooting sound/gunshot
權利聲明	权利声明	quán lì shēng míng	copyright statement
次聲波	次声波	cì shēng bō	infrasonic wave
歌聲	歌声	gē shēng	singing voice/fig. original voice of a poet
歡聲	欢声	huān shēng	cheers/cries of joy or approval
氣動噪聲	气动噪声	qì dòng zào shēng	aerodynamic noise
消聲	消声	xiāo shēng	sound dissipation/noise reduction
消聲器	消声器	xiāo shēng qì	noise reduction equipment
滴答聲	滴答声	dī da shēng	tick (tock)
無聲	无声	wú shēng	noiseless/noiselessly/silent
無聲無息	无声无息	wú shēng wú xī	wordless and uncommunicative (idiom); without speaking/taciturn/not providing any news
爆聲	爆声	bào shēng	explosion/bang/sonic boom/engine knock
狀聲詞	状声词	zhuàng shēng cí	onomatopoeia
甕聲甕氣	瓮声瓮气	wèng shēng wèng qì	to speak in a low muffled voice (idiom)
留聲機	留声机	liú shēng jī	gramophone/phonograph
異口同聲	异口同声	yì kǒu tóng shēng	different mouths, same voice/to speak in unison (idiom)
發嘎嘎聲	发嘎嘎声	fā gā gā shēng	rattle
發噓聲	发嘘声	fā xū shēng	to hiss (as a sign of displeasure)
發聲	发声	fā shēng	vocal/sound/sound production/to utter/to give voice
發聲器	发声器	fā shēng qì	sound device
發聲器官	发声器官	fā shēng qì guān	vocal organs/vocal cords
發聲法	发声法	fā shēng fǎ	intonation
相聲	相声	xiàng sheng	comic dialogue/sketch/crosstalk
真聲	真声	zhēn shēng	natural voice/modal voice/true voice/opposite: falsetto 假聲|假声[jiǎ shēng]
真聲最高音	真声最高音	zhēn shēng zuì gāo yīn	highest true (non-falsetto) voice
眾口同聲	众口同声	zhòng kǒu tóng shēng	(of people) to be of one voice (idiom)/unanimous
竊聲	窃声	qiè shēng	in a whisper/in stealthy tones
立體聲	立体声	lì tǐ shēng	stereo sound
笑聲	笑声	xiào shēng	laughter
第一聲	第一声	dì yī shēng	first tone in Mandarin/high, level tone
第三聲	第三声	dì sān shēng	third tone in Mandarin/falling-rising tone
第二聲	第二声	dì èr shēng	second tone in Mandarin/rising tone
第四聲	第四声	dì sì shēng	fourth tone in Mandarin/falling tone
細聲細氣	细声细气	xì shēng xì qì	in a fine voice (idiom); softly spoken
終場鑼聲	终场锣声	zhōng chǎng luó shēng	the final bell (esp. in sports competition)
終聲	终声	zhōng shēng	final (i.e. final consonant or stop of some syllables in Asian phonetics)
縱聲	纵声	zòng shēng	loudly/in a loud voice
繪聲繪色	绘声绘色	huì shēng huì sè	vivid and colorful (idiom); true to life/lively and realistic
美聲	美声	měi shēng	bel canto
美聲唱法	美声唱法	měi shēng chàng fǎ	bel canto
聯合聲明	联合声明	lián hé shēng míng	joint declaration
B型超聲	B型超声	B xíng chāo shēng	type-B ultrasound
聲像	声像	shēng xiàng	audio-visual/(ultrasonography etc) acoustic image
聲價	声价	shēng jià	reputation
聲優	声优	shēng yōu	voice actor (loanword from Japanese 声優 seiyū)
聲勢	声势	shēng shì	fame and power/prestige/influence/impetus/momentum
聲卡	声卡	shēng kǎ	sound card
聲名	声名	shēng míng	reputation/declaration
聲名大噪	声名大噪	shēng míng dà zào	to rise to fame
聲名大震	声名大震	shēng míng dà zhèn	to create a sensation
聲名狼藉	声名狼藉	shēng míng láng jí	to have a bad reputation
聲吶	声呐	shēng nà	sonar
聲嘶力竭	声嘶力竭	shēng sī lì jié	to shout oneself hoarse (idiom)
聲囊	声囊	shēng náng	vocal sac/vocal pouch (for vocal amplification in male frogs)
聲威	声威	shēng wēi	prestige/renown/influence
聲學	声学	shēng xué	acoustics
聲帶	声带	shēng dài	vocal cords/vocal folds/(motion picture) soundtrack
聲張	声张	shēng zhāng	to make public/to disclose
聲息	声息	shēng xī	sound (often with negative, not a sound)/whisper
聲情並茂	声情并茂	shēng qíng bìng mào	(of a singer etc) excellent in voice and expression (idiom)
聲押	声押	shēng yā	to apply to a court for an arrest warrant
聲援	声援	shēng yuán	to support (a cause)
聲旁	声旁	shēng páng	phonetic component of Chinese character
聲旁字	声旁字	shēng páng zì	character serving as sound value of another character/phonetic
聲旁錯誤	声旁错误	shēng páng cuò wù	phonological error
聲明	声明	shēng míng	to state/to declare/statement/declaration/CL:項|项[xiàng],份[fèn]
聲明書	声明书	shēng míng shū	statement
聲望	声望	shēng wàng	popularity/prestige
聲東擊西	声东击西	shēng dōng jī xī	to threaten the east and strike to the west (idiom)/to create a diversion
聲樂	声乐	shēng yuè	vocal music
聲母	声母	shēng mǔ	consonant/the initial consonant (of a Chinese syllable)
聲氣	声气	shēng qì	voice/tone/information
聲波	声波	shēng bō	sound wave
聲波定位	声波定位	shēng bō dìng wèi	sonic location system (esp. underwater sonar)/acoustic positioning
聲浪	声浪	shēng làng	clamor
聲淚俱下	声泪俱下	shēng lèi jù xià	to shed tears while recounting sth/speaking in a tearful voice
聲稱	声称	shēng chēng	to claim/to state/to proclaim/to assert
聲符	声符	shēng fú	phonetic component of a Chinese character
聲納	声纳	shēng nà	sonar (sound navigation and ranging) (loanword)
聲索國	声索国	shēng suǒ guó	claimant country (in a territorial dispute)
聲線	声线	shēng xiàn	tone of voice/timbre
聲色場所	声色场所	shēng sè chǎng suǒ	red-light district
聲言	声言	shēng yán	to state/to declare/pronouncement/declaration
聲討	声讨	shēng tǎo	to denounce/to condemn
聲訓	声训	shēng xùn	explaining a character or word by using a homophone
聲說	声说	shēng shuō	to narrate
聲調	声调	shēng diào	tone/note/a tone (on a Chinese syllable)/CL:個|个[gè]
聲調語言	声调语言	shēng diào yǔ yán	tonal language (e.g. Chinese or Vietnamese)
聲調輪廓	声调轮廓	shēng diào lún kuò	tone contour
聲請	声请	shēng qǐng	to make a formal request/formal request/to make a claim (law)
聲譽	声誉	shēng yù	reputation/fame
聲道	声道	shēng dào	sound track/audio channel
聲門	声门	shēng mén	glottis
聲音	声音	shēng yīn	voice/sound/CL:個|个[gè]
聲韻學	声韵学	shēng yùn xué	phonetics
聲響	声响	shēng xiǎng	sound/noise
聲頻	声频	shēng pín	audio frequency
聲類	声类	Shēng lèi	Shenglei, the earliest Chinese rime dictionary with 11,520 single-character entries, released in 3rd century (was not preserved to this day)
聲類系統	声类系统	shēng lèi xì tǒng	phonetic system
聲鵐	声鹀	shēng wú	(bird species of China) common reed bunting (Emberiza schoeniclus)
聽話聽聲，鑼鼓聽音	听话听声，锣鼓听音	tīng huà tīng shēng , luó gǔ tīng yīn	to understand the unspoken implications (idiom)
萬籟無聲	万籁无声	wàn lài wú shēng	not a sound to be heard (idiom)/dead silent
虛張聲勢	虚张声势	xū zhāng shēng shì	(false) bravado/to bluff
蜚聲	蜚声	fēi shēng	to make a name/to become famous
蜚聲世界	蜚声世界	fēi shēng shì jiè	famous throughout the world
蜚聲海外	蜚声海外	fēi shēng hǎi wài	famous at home and abroad
蟲鳥叫聲	虫鸟叫声	chóng niǎo jiào shēng	chirp
衍聲複詞	衍声复词	yǎn shēng fù cí	compound word such as 玫瑰[méi guī], 咖啡[kā fēi], whose meaning is unrelated to the component hanzi, which often cannot be used singly
言為心聲	言为心声	yán wéi xīn shēng	one's words reflect one's thinking (idiom)
語聲	语声	yǔ shēng	spoken language/sound of speaking
變徵之聲	变徵之声	biàn zhǐ zhī shēng	modified fifth note of the pentatonic scale
變聲	变声	biàn shēng	voice change (at puberty)/to alter one's voice (deliberately)/to sound different (when angry etc)
象聲詞	象声词	xiàng shēng cí	onomatopoeia
貓叫聲	猫叫声	māo jiào shēng	mew
貓聲鳥	猫声鸟	māo shēng niǎo	catbird
賴聲川	赖声川	Lài Shēng chuān	Lai Shengchuan (1954-), US-Taiwanese dramatist and director
超聲	超声	chāo shēng	ultrasonic/ultrasound
超聲掃描	超声扫描	chāo shēng sǎo miáo	ultrasonic scan
超聲波	超声波	chāo shēng bō	ultrasound (scan)
超聲波檢查	超声波检查	chāo shēng bō jiǎn chá	echography/ultrasound scan
超聲頻	超声频	chāo shēng pín	ultrasonic/beyond human hearing
輕聲	轻声	qīng shēng	quietly/softly/neutral tone/light stress
輕聲細語	轻声细语	qīng shēng xì yǔ	to speak softly/to whisper (idiom)
連聲	连声	lián shēng	repeatedly (say something)
邊聲	边声	biān shēng	outlandish sounds (wind blowing on frontier, wild horses neighing etc)
采聲	采声	cǎi shēng	applause
鈴聲	铃声	líng shēng	ring/ringtone/bell stroke/tintinnabulation
銷聲匿跡	销声匿迹	xiāo shēng nì jì	to vanish without trace (idiom)/to lie low
鑼聲	锣声	luó shēng	sound of gong
陰平聲	阴平声	yīn píng shēng	high and level tone, the first tone of putonghua
陽平聲	阳平声	yáng píng shēng	evenly rising tone, the second tone of putonghua
隆隆聲	隆隆声	lóng lóng shēng	rumble (sound of thunder or gunfire)
隨聲附和	随声附和	suí shēng fù hè	to parrot other people's words (idiom); to chime in with others
零聲母	零声母	líng shēng mǔ	(Chinese linguistics) zero initial (the initial of a syllable that does not begin with a consonant)
雷聲	雷声	léi shēng	thunder
雷聲大，雨點小	雷声大，雨点小	léi shēng dà , yǔ diǎn xiǎo	loud thunder, but only tiny drops of rain (idiom); a lot of talk, but no action/action speaks louder than words/his bite is worse than his bark
電磁噪聲	电磁噪声	diàn cí zào shēng	electromagnetic noise
電話鈴聲	电话铃声	diàn huà líng shēng	(telephone) ring/ringing
音樂之聲	音乐之声	Yīn yuè zhī shēng	The Sound of Music, Broadway musical (1959) and Academy Award-winning movie (1965)
響聲	响声	xiǎng shēng	noise
頌聲載道	颂声载道	sòng shēng zài dào	lit. praise fills the roads (idiom); praise everywhere/universal approbation
顫聲	颤声	chàn shēng	trill (of voice)/see also 顫聲|颤声[zhàn shēng]
顫聲	颤声	zhàn shēng	trembling voice/see also 顫聲|颤声[chàn shēng]
風聲	风声	fēng shēng	sound of the wind/rumor/talk/news/reputation
風聲緊	风声紧	fēng shēng jǐn	(fig.) the situation is tense
風聲鶴唳	风声鹤唳	fēng shēng hè lì	lit. wind sighing and crane calling (idiom)/fig. to panic at the slightest move/to be jittery
飲恨吞聲	饮恨吞声	yǐn hèn tūn shēng	to harbor a grudge with deep-seated hatred (idiom)
高聲	高声	gāo shēng	aloud/loud/loudly
鴉雀無聲	鸦雀无声	yā què wú shēng	lit. crow and peacock make no sound/absolute silence (idiom); not a single voice can be heard/absolute silence
默不作聲	默不作声	mò bù zuò shēng	to keep silent
鼓聲	鼓声	gǔ shēng	sound of a drum/drumbeat
鼾聲	鼾声	hān shēng	sound of snoring
鼾聲如雷	鼾声如雷	hān shēng rú léi	thunderous snoring
齊聲	齐声	qí shēng	all speaking together/in chorus
