漂	漂	piāo	to float/to drift
漂	漂	piǎo	to bleach
漂	漂	piào	elegant/polished
打水漂	打水漂	dǎ shuǐ piāo	to skip stones (on water)/(coll.) to squander one's money on a bad investment
洋漂族	洋漂族	yáng piāo zú	lit. ocean drifting people/job-hopping foreigner
浮漂	浮漂	fú piāo	see 漂浮[piāo fú]
北漂	北漂	Běi piāo	migrant worker living and working in Beijing without a residence permit
大陸漂移	大陆漂移	dà lù piāo yí	continental drift
愛漂亮	爱漂亮	ài piào liang	to like looking attractive (usually of girls)/aestheticism
漂亮	漂亮	piào liang	pretty/beautiful
漂搖	漂摇	piāo yáo	swaying/tottering/unstable
漂染	漂染	piǎo rǎn	to bleach and dye
漂泊	漂泊	piāo bó	to drift (in the tide)/to rove/to lead a wandering existence/drifter/wanderer
漂洋	漂洋	piāo yáng	to cross the ocean
漂洗	漂洗	piǎo xǐ	to rinse (clothes)
漂流	漂流	piāo liú	to float on the current/to drift along or about/rafting
漂流瓶	漂流瓶	piāo liú píng	message in a bottle
漂流者	漂流者	piāo liú zhě	white water rafter/paddler/river runner
漂浮	漂浮	piāo fú	to float/to hover/to drift (also fig., to lead a wandering life)/to rove/showy/superficial
漂白	漂白	piǎo bái	to bleach/to whiten
漂白劑	漂白剂	piǎo bái jì	bleach
漂白水	漂白水	piǎo bái shuǐ	bleach
漂礫	漂砾	piāo lì	boulder
漂移	漂移	piāo yí	to drift
漂蕩	漂荡	piāo dàng	variant of 飄盪|飘荡[piāo dàng]
漂走	漂走	piào zǒu	to float away/to drift/to be swept off
漂遊	漂游	piāo yóu	drift
漂零	漂零	piāo líng	variant of 飄零|飘零[piāo líng]
漂雷	漂雷	piāo léi	floating mine
漂鷸	漂鹬	piāo yù	(bird species of China) wandering tattler (Tringa incana)
灰尾漂鷸	灰尾漂鹬	huī wěi piāo yù	(bird species of China) grey-tailed tattler (Tringa brevipes)
血流漂杵	血流漂杵	xuè liú piāo chǔ	enough blood flowing to float pestles (idiom); rivers of blood/blood bath
長漂	长漂	Cháng piāo	rafting on the Yangtze River/abbr. for 長江漂流|长江漂流
風雨漂搖	风雨漂摇	fēng yǔ piāo yáo	tossed about by the wind and rain (idiom)/(of a situation) unstable
魚漂	鱼漂	yú piāo	fishing float
黃漂	黄漂	Huáng piāo	rafting on the Yellow River/abbr. for 黃河漂流|黄河漂流
