旋	旋	xuán	to revolve/a loop/a circle
旋	旋	xuàn	to whirl/immediately/variant of 鏇|镟[xuàn]
主旋律	主旋律	zhǔ xuán lǜ	theme or subject (music)
休氏旋木雀	休氏旋木雀	Xiū shì xuán mù què	(bird species of China) Hume's treecreeper (Certhia manipurensis)
凱旋	凯旋	kǎi xuán	to return in triumph/to return victorious
凱旋門	凯旋门	kǎi xuán mén	triumphal arch
包柔氏螺旋體	包柔氏螺旋体	Bāo róu shì luó xuán tǐ	Borrelia, genus of Spirochaete bacteria
包氏螺旋體	包氏螺旋体	Bāo shì luó xuán tǐ	Borrelia, genus of Spirochaete bacteria
反氣旋	反气旋	fǎn qì xuán	anticyclone
周旋	周旋	zhōu xuán	to mix with others/to socialize/to deal with/to contend
四川旋木雀	四川旋木雀	Sì chuān xuán mù què	(bird species of China) Sichuan treecreeper (Certhia tianquanensis)
回旋	回旋	huí xuán	to cycle around/cyclotron/slalom
回旋加速器	回旋加速器	huí xuán jiā sù qì	cyclotron (particle accelerator)
回旋曲	回旋曲	huí xuán qǔ	rondo
回旋餘地	回旋余地	huí xuán yú dì	leeway/latitude/room for freedom of action
土耳其旋轉烤肉	土耳其旋转烤肉	Tǔ ěr qí xuán zhuǎn kǎo ròu	Turkish döner kebab
天旋地轉	天旋地转	tiān xuán dì zhuàn	the sky spins, the earth goes round (idiom); giddy with one's head spinning/fig. huge changes in the world
幽門螺旋桿菌	幽门螺旋杆菌	yōu mén luó xuán gǎn jūn	Helicobacter pylori (stomach bacterium)
幽門螺旋菌	幽门螺旋菌	yōu mén luó xuán jūn	Helicobacter pylori (stomach bacterium)
打旋	打旋	dǎ xuán	to revolve
打旋兒	打旋儿	dǎ xuán r5	erhua variant of 打旋[dǎ xuán]
斡旋	斡旋	wò xuán	to mediate (a conflict etc)
下旋	下旋	xià xuán	(sport) backspin
下旋削球	下旋削球	xià xuán xiāo qiú	(golf, tennis) undercut
旋乾轉坤	旋乾转坤	xuán qián zhuǎn kūn	lit. overturning heaven and earth (idiom); earth-shattering/a radical change
旋光	旋光	xuán guāng	rotation of plane of polarization of light
旋前肌	旋前肌	xuán qián jī	pronator teres muscle (below the elbow)
旋即	旋即	xuán jí	soon after/shortly
旋回	旋回	xuán huí	to cycle
旋子	旋子	xuán zi	torsor (math.)
旋子	旋子	xuàn zi	whirlwind somersault (in gymnastics or martial arts)
旋律	旋律	xuán lǜ	melody/rhythm
旋木雀	旋木雀	xuán mù què	(bird species of China) Eurasian treecreeper (Certhia familiaris)
旋梯	旋梯	xuán tī	spiral stairs/winding stairs (gymnastic equipment)
旋流	旋流	xuán liú	rotating flow
旋淵	旋渊	xuán yuān	abyss
旋渦	旋涡	xuán wō	spiral/whirlpool/eddy/vortex
旋渦星系	旋涡星系	xuán wō xīng xì	spiral galaxy
旋渦星雲	旋涡星云	xuán wō xīng yún	spiral nebula
旋渦狀	旋涡状	xuán wō zhuàng	spiral-shaped
旋筒	旋筒	xuán tǒng	rotor/turbine
旋繞	旋绕	xuán rào	to curl up/to wind around
旋翼	旋翼	xuán yì	rotor wing
旋臂	旋臂	xuán bì	spiral arm
旋舞	旋舞	xuán wǔ	whirling dance
旋花科	旋花科	xuán huā kē	Convolvulaceae, herbaceous plant family
旋覆花	旋覆花	xuán fù huā	(botany) convolvulvus/Flos Inulae (Chinese herb)
旋踵	旋踵	xuán zhǒng	to turn on one's heel/in the twinkle of an eye/instantly
旋轉	旋转	xuán zhuǎn	to rotate/to revolve/to spin/to whirl
旋轉力	旋转力	xuán zhuǎn lì	turning force/torque
旋轉台	旋转台	xuán zhuǎn tái	rotating platform/luggage carousel
旋轉指標	旋转指标	xuán zhuǎn zhǐ biāo	winding number
旋轉曲面	旋转曲面	xuán zhuǎn qū miàn	a surface of revolution (math.)
旋轉木馬	旋转木马	xuán zhuǎn mù mǎ	merry-go-round/carousel/Carousel, South Korean TV soap opera
旋轉極	旋转极	xuán zhuǎn jí	pole of rotation
旋轉烤肉	旋转烤肉	xuán zhuǎn kǎo ròu	döner kebab
旋轉球	旋转球	xuán zhuǎn qiú	spin ball
旋轉行李傳送帶	旋转行李传送带	xuán zhuǎn xíng li chuán sòng dài	luggage conveyor belt/carousel
旋轉角	旋转角	xuán zhuǎn jiǎo	angle of rotation
旋轉角速度	旋转角速度	xuán zhuǎn jiǎo sù dù	rotational angular velocity
旋轉軸	旋转轴	xuán zhuǎn zhóu	axis of rotation
旋轉運動	旋转运动	xuán zhuǎn yùn dòng	rotation/rotary motion
旋里	旋里	xuán lǐ	to return home
旋量	旋量	xuán liàng	spinor (math.)
旋鈕	旋钮	xuán niǔ	knob (e.g. handle or radio button)
旋閘	旋闸	xuán zhá	rotor sluice gate
旋風	旋风	xuàn fēng	whirlwind/tornado
旋風腳	旋风脚	xuàn fēng jiǎo	whirlwind kick (martial arts)
核自旋	核自旋	hé zì xuán	nuclear spin
棒旋星系	棒旋星系	bàng xuán xīng xì	barred spiral galaxy
氣旋	气旋	qì xuán	cyclone
油旋	油旋	yóu xuán	Youxuan, a kind of a pastry
渦旋	涡旋	wō xuán	eddy/vortex
準穩旋渦結構	准稳旋涡结构	zhǔn wěn xuán wō jié gòu	quasi-stationary spiral structure QSSS (astrophysics)
環極渦旋	环极涡旋	huán jí wō xuán	circumpolar vortex
皮劃艇激流回旋	皮划艇激流回旋	pí huá tǐng jī liú huí xuán	canoe-kayak slalom
盤旋	盘旋	pán xuán	to spiral/to circle/to go around/to hover/to orbit
盤旋曲折	盘旋曲折	pán xuán qū zhé	lit. windy and circuitous/difficult (idiom)
禍不旋踵	祸不旋踵	huò bù xuán zhǒng	trouble is never far away (idiom)
紅翅旋壁雀	红翅旋壁雀	hóng chì xuán bì què	(bird species of China) wallcreeper (Tichodroma muraria)
蝸旋	蜗旋	wō xuán	to spiral
螺旋	螺旋	luó xuán	spiral/helix/screw
螺旋千斤頂	螺旋千斤顶	luó xuán qiān jīn dǐng	screw jack
螺旋形	螺旋形	luó xuán xíng	spiral
螺旋曲面	螺旋曲面	luó xuán qū miàn	spiral surface
螺旋槳	螺旋桨	luó xuán jiǎng	propeller
螺旋粉	螺旋粉	luó xuán fěn	fusilli (corkscrew shaped pasta)
螺旋藻	螺旋藻	luó xuán zǎo	spiral algae/spirulina (dietary supplement)
螺旋鉗	螺旋钳	luó xuán qián	wrench
螺旋體	螺旋体	luó xuán tǐ	Spirochaetes, phylum of extremophile bacteria/spiral-shaped bacterium, e.g. causing syphilis
螺旋麵	螺旋面	luó xuán miàn	fusilli (pasta)
褐喉旋木雀	褐喉旋木雀	hè hóu xuán mù què	(bird species of China) Sikkim treecreeper (Certhia discolor)
軸旋轉	轴旋转	zhóu xuán zhuǎn	to rotate about an axis/axis of rotation (math.)
迴旋	回旋	huí xuán	to turn around/maneuvering room/leeway
鉤端螺旋體病	钩端螺旋体病	gōu duān luó xuán tǐ bìng	leptospirosis
鏇子	旋子	xuàn zi	large metal plate for making bean curd/metal pot for warming wine
鏇工	旋工	xuàn gōng	lathe operator/spinning wheel worker
鏇床	旋床	xuàn chuáng	lathe
鏇木	旋木	xuàn mù	wood turning/woodwork lathe
鏽紅腹旋木雀	锈红腹旋木雀	xiù hóng fù xuán mù què	(bird species of China) rusty-flanked treecreeper (Certhia nipalensis)
霍氏旋木雀	霍氏旋木雀	Huò shì xuán mù què	(bird species of China) Hodgson's treecreeper (Certhia hodgsoni)
高山旋木雀	高山旋木雀	gāo shān xuán mù què	(bird species of China) bar-tailed treecreeper (Certhia himalayana)
髮旋	发旋	fà xuán	hair whorl
黑旋風	黑旋风	Hēi Xuàn fēng	Black Whirlwind, nickname of 李逵[Lǐ Kuí], known for his fearsome behavior in combat and his dark complexion
