斷	断	duàn	to break/to snap/to cut off/to give up or abstain from sth/to judge/(usu. used in the negative) absolutely/definitely/decidedly
不斷	不断	bù duàn	unceasing/uninterrupted/continuous/constant
中斷	中断	zhōng duàn	to cut short/to break off/to discontinue/to interrupt
了斷	了断	liǎo duàn	to bring to a conclusion/to settle (a dispute)/to do away with (oneself)/to break off (a relationship)/resolution (of a problem)
傷筋斷骨	伤筋断骨	shāng jīn duàn gǔ	to suffer serious injury (idiom)
優柔寡斷	优柔寡断	yōu róu guǎ duàn	indecisive/irresolute
公斷	公断	gōng duàn	arbitration (law)
切斷	切断	qiē duàn	to cut off/to sever
判斷	判断	pàn duàn	to judge/to determine/judgment
判斷力	判断力	pàn duàn lì	ability to judge/judgment
判斷語	判断语	pàn duàn yǔ	predicate
剪斷	剪断	jiǎn duàn	to cut/to snip
割斷	割断	gē duàn	to cut off/to sever
割袍斷義	割袍断义	gē páo duàn yì	to rip one's robe as a sign of repudiating a sworn brotherhood (idiom)/to break all friendly ties
反壟斷	反垄断	fǎn lǒng duàn	anti-trust legislation/anti-monopoly
反壟斷法	反垄断法	fǎn lǒng duàn fǎ	anti-trust law/legislation again monopolies
喝斷片	喝断片	hē duàn piàn	to get blackout drunk (slang)
壟斷	垄断	lǒng duàn	to enjoy market dominance/to monopolize
壟斷販賣	垄断贩卖	lǒng duàn fàn mài	monopoly
多謀善斷	多谋善断	duō móu shàn duàn	resourceful and decisive/resolute and sagacious
夾斷	夹断	jiā duàn	to nip (i.e. cut short)/to pinch off
妄斷	妄断	wàng duàn	to jump to an unfounded conclusion
寡頭壟斷	寡头垄断	guǎ tóu lǒng duàn	oligopoly
審斷	审断	shěn duàn	to examine
專斷	专断	zhuān duàn	to act arbitrarily/to make decisions without consulting others
快刀斷亂麻	快刀断乱麻	kuài dāo duàn luàn má	lit. quick sword cuts through tangled hemp (idiom); decisive action in a complex situation/cutting the Gordian knot
恩斷義絕	恩断义绝	ēn duàn yì jué	to split up/to break all ties
應機立斷	应机立断	yìng jī lì duàn	to act on an opportunity (idiom); to take prompt advantage of a situation
戒斷	戒断	jiè duàn	withdrawal (from drugs)
截斷	截断	jié duàn	to break or cut in two/to sever/to cut off/(fig.) to cut off (a conversation, a flow etc)/to interrupt/(math.) to truncate
打斷	打断	dǎ duàn	to interrupt/to break off/to break (a bone)
投鞭斷流	投鞭断流	tóu biān duàn liú	arms enough to stem the stream (idiom); formidable army
折斷	折断	zhé duàn	to snap sth off/to break
拗斷	拗断	ào duàn	to break by twisting
掐斷	掐断	qiā duàn	cut off/disconnect
掛斷	挂断	guà duàn	to hang up (a phone)
接連不斷	接连不断	jiē lián bù duàn	in unbroken succession (idiom)
推斷	推断	tuī duàn	to infer/to deduce/to predict/to extrapolate
摔斷	摔断	shuāi duàn	to fall and break/to break (bones) by falling
擅斷	擅断	shàn duàn	arbitrary
斬斷	斩断	zhǎn duàn	to cut off/to chop sth in half
一刀兩斷	一刀两断	yī dāo liǎng duàn	lit. two segments with a single cut (idiom)/fig. to make a clean break (idiom)
斷乎	断乎	duàn hū	certainly
斷交	断交	duàn jiāo	to end a relationship/to break off diplomatic ties
斷代	断代	duàn dài	periodization (of history)
斷句	断句	duàn jù	to pause at appropriate points in reading aloud unpunctuated writing/to punctuate
斷奶	断奶	duàn nǎi	to wean
斷子絕孫	断子绝孙	duàn zǐ jué sūn	to die without progeny/(offensive) may you die childless/may you be the last of your family line
斷定	断定	duàn dìng	to conclude/to determine/to come to a judgment
斷層	断层	duàn céng	fault (geology)/CL:道[dào],個|个[gè]/(fig.) gap/rupture (in the transmission of some skill)/(tomography) cross-sectional
斷層線	断层线	duàn céng xiàn	geological fault line
斷崖	断崖	duàn yá	steep cliff/crag/precipice
斷弦	断弦	duàn xián	widowed/lit. broken string, cf 琴瑟[qín sè] qin and se, two instruments epitomizing marital harmony
斷想	断想	duàn xiǎng	brief commentary
斷斷續續	断断续续	duàn duàn xù xù	intermittent/off and on/discontinuous/stop-go/stammering/disjointed/inarticulate
斷案	断案	duàn àn	to judge a case
斷橋	断桥	Duàn Qiáo	The Broken Bridge (at West Lake in Hangzhou)
斷檔	断档	duàn dàng	sold out/to be out of stock
斷氣	断气	duàn qì	to stop breathing/to breathe one's last/to die/to cut the gas supply
斷流	断流	duàn liú	to run dry (of river)
斷港絕潢	断港绝潢	duàn gǎng jué huáng	to be unable to continue/to come to a dead end (idiom)
斷滅	断灭	duàn miè	annihilation (of soul, Sanskrit uccheda)
斷滅論	断灭论	duàn miè lùn	annihilation (of soul, Sanskrit uccheda)
斷然	断然	duàn rán	resolute/definitive/categorically/absolutely
斷片	断片	duàn piàn	fragment/piece/(of a film) to break in the middle of viewing
斷獄	断狱	duàn yù	to pass judgment on a legal case
斷球	断球	duàn qiú	(sports) to steal/to intercept the ball
斷瓦殘垣	断瓦残垣	duàn wǎ cán yuán	the tiles are broken, the walls dilapidated
斷章取義	断章取义	duàn zhāng qǔ yì	to quote out of context (idiom)
斷糧	断粮	duàn liáng	to run out of food
斷絕	断绝	duàn jué	to sever/to break off
斷線	断线	duàn xiàn	(of a guitar, kite etc) to have a string break/(of a tradition etc) to be discontinued/(telephone or Internet connection) disconnected/cut off
斷線鉗	断线钳	duàn xiàn qián	bolt cutter
斷線風箏	断线风筝	duàn xiàn fēng zhēng	a kite with cut string (idiom); fig. gone beyond recall
斷續	断续	duàn xù	intermittent
斷背	断背	duàn bèi	homosexual (a reference to Brokeback Mountain 斷背山|断背山[Duàn bèi Shān], a 2005 movie about a same-sex relationship)
斷背山	断背山	Duàn bèi Shān	Brokeback Mountain, 2005 English-language film by Ang Lee 李安[Lǐ Ān]
斷腸	断肠	duàn cháng	heartbroken/to break one's heart
斷腿	断腿	duàn tuǐ	broken leg
斷行	断行	duàn háng	line break (computing)
斷行	断行	duàn xíng	to carry out resolutely
斷袖	断袖	duàn xiù	homosexual/see 斷袖之癖|断袖之癖[duàn xiù zhī pǐ]
斷袖之癖	断袖之癖	duàn xiù zhī pǐ	lit. cut sleeve (idiom); fig. euphemism for homosexuality, originating from History of Western Han 漢書|汉书: emperor Han Aidi (real name Liu Xin) was in bed with his lover Dong Xian, and had to attend a court audience that morning. Not wishing to awaken Dong Xian, who was sleeping with his head resting on the emperor's long robe sleeve, Aidi used a knife to cut off the lower half of his sleeve.
斷裂	断裂	duàn liè	fracture/rupture/to break apart
斷裂帶	断裂带	duàn liè dài	fault zone (geology)
斷裂強度	断裂强度	duàn liè qiáng dù	rupture strength/breaking strength
斷裂模數	断裂模数	duàn liè mó shù	modulus rupture
斷言	断言	duàn yán	to assert/assertion
斷語	断语	duàn yǔ	conclusion/judgment/verdict
斷貨	断货	duàn huò	to run out of (stock)
斷路器	断路器	duàn lù qì	circuit breaker
斷送	断送	duàn sòng	to forfeit (future profit, one's life etc)/ruined
斷開	断开	duàn kāi	to break/to sever/to turn off (electric switch)
斷電	断电	duàn diàn	power cut/electric power failure
斷頭台	断头台	duàn tóu tái	guillotine/scaffold
斷食	断食	duàn shí	to fast/hunger strike
斷魂椒	断魂椒	duàn hún jiāo	king cobra or ghost chili (Naga jolokia)
時斷時續	时断时续	shí duàn shí xù	stopping and starting/intermittent/sporadic/on and off
果斷	果断	guǒ duàn	firm/decisive
柔腸寸斷	柔肠寸断	róu cháng cùn duàn	lit. to feel as if one's intestines have been cut short/broken-hearted (idiom)
橫斷	横断	héng duàn	to cross (a road, an ocean etc)/to cut across
橫斷山脈	横断山脉	Héng duàn shān mài	Hengduan mountains, several parallel mountain ranges on the border between west Yunnan and Sichuan and east Tibet
橫斷步道	横断步道	héng duàn bù dào	pedestrian crossing
橫斷物	横断物	héng duàn wù	transverse object
橫斷面	横断面	héng duàn miàn	horizontal section
正斷層	正断层	zhèng duàn céng	normal fault (geology)
正電子斷層	正电子断层	zhèng diàn zǐ duàn céng	PET, positron emission tomography (medical imaging method)
正電子照射斷層攝影	正电子照射断层摄影	zhèng diàn zǐ zhào shè duàn céng shè yǐng	positrion emission tomography (PET)
正電子發射斷層照相術	正电子发射断层照相术	zhèng diàn zǐ fā shè duàn céng zhào xiāng shù	positron emission tomography (PET)
正電子發射計算機斷層	正电子发射计算机断层	zhèng diàn zǐ fā shè jì suàn jī duàn céng	PET, positron emission tomography (medical imaging method)
武斷	武断	wǔ duàn	arbitrary/subjective/dogmatic
殘垣斷壁	残垣断壁	cán yuán duàn bì	crumbling fences and dilapidated walls (idiom)
決斷	决断	jué duàn	to make a decision/resolution/decisiveness/resolute
清官難斷家務事	清官难断家务事	qīng guān nán duàn jiā wù shì	even an honest and upright official will have difficulty resolving a family dispute (proverb)
源源不斷	源源不断	yuán yuán bù duàn	a steady flow (idiom); an unending stream
熔斷	熔断	róng duàn	(of fuse wire) to melt/to blow
熔斷機制	熔断机制	róng duàn jī zhì	(finance) trading curb/circuit breaker
熔斷絲	熔断丝	róng duàn sī	fuse wire
片斷	片断	piàn duàn	section/fragment/segment
獨斷	独断	dú duàn	to decide alone without consultation/arbitrary/dictatorial
獨斷專行	独断专行	dú duàn zhuān xíng	to decide and act alone (idiom); to take arbitrary action/a law unto oneself
獨斷獨行	独断独行	dú duàn dú xíng	to decide and act alone (idiom); to take arbitrary action/a law unto oneself
當斷則斷	当断则断	dāng duàn zé duàn	to make a decision when it's time to decide
當斷即斷	当断即断	dāng duàn jí duàn	not to delay making a decision when a decision is needed
當機立斷	当机立断	dāng jī lì duàn	to make prompt decisions (idiom)
眼穿腸斷	眼穿肠断	yǎn chuān cháng duàn	waiting anxiously (idiom)
砍斷	砍断	kǎn duàn	to chop off
縱斷面	纵断面	zòng duàn miàn	vertical section/longitudinal section
聖安地列斯斷層	圣安地列斯断层	Shèng ān de liè sī Duàn céng	San Andreas Fault, California/also written 聖安德列斯斷層|圣安德列斯断层
聖安德列斯斷層	圣安德列斯断层	Shèng ān dé liè sī Duàn céng	San Andreas Fault, California
聽斷	听断	tīng duàn	to judge (i.e. to hear and pass judgment in a law court)/to hear and decide
肝腸寸斷	肝肠寸断	gān cháng cùn duàn	lit. liver and guts cut to pieces (idiom)/fig. grief-stricken
臆斷	臆断	yì duàn	to assume/assumption
自行了斷	自行了断	zì xíng liǎo duàn	to take one's life
英明果斷	英明果断	yīng míng guǒ duàn	wise and resolute
藕斷絲連	藕断丝连	ǒu duàn sī lián	lit. lotus roots may break, but the fiber remains joined (idiom); lovers part, but still long for one another
衝斷層	冲断层	chōng duàn céng	thrust fault (geology)/compression fault
裁斷	裁断	cái duàn	to consider and decide
計算機斷層	计算机断层	jì suàn jī duàn céng	CT, computed tomography (medical imaging method)
診斷	诊断	zhěn duàn	diagnosis/to diagnose
評斷	评断	píng duàn	to judge
詞彙判斷	词汇判断	cí huì pàn duàn	lexical decision
詞彙判斷任務	词汇判断任务	cí huì pàn duàn rèn wu	lexical decision task (psychology)
詞彙判斷作業	词汇判断作业	cí huì pàn duàn zuò yè	lexical decision task
詞彙判斷法	词汇判断法	cí huì pàn duàn fǎ	lexical decision task
論斷	论断	lùn duàn	to infer/to judge/inference/judgment/conclusion
識文斷字	识文断字	shí wén duàn zì	literate/a cultured person
買斷	买断	mǎi duàn	to buy out/buyout/severance
走向斷層	走向断层	zǒu xiàng duàn céng	strike fault (geology)
走向滑動斷層	走向滑动断层	zǒu xiàng huá dòng duàn céng	strike-slip fault (geology)/fault line where the two sides slide horizontally past one another
跌斷	跌断	diē duàn	to fall and fracture (a leg, vertebra etc)
轉換斷層	转换断层	zhuǎn huàn duàn céng	transform fault (geology)
逆斷層	逆断层	nì duàn céng	reverse fault (geology)/compression fault, where one block pushes over the other at dip of less than 45 degrees
連續不斷	连续不断	lián xù bù duàn	continuous/unceasing
逸塵斷鞅	逸尘断鞅	yì chén duàn yāng	lit. kicking up the dust and breaking the harness/fig. to ride like the wind (idiom)
遮斷	遮断	zhē duàn	to cut off/to interrupt/to prevent access
長流水，不斷線	长流水，不断线	cháng liú shuǐ , bù duàn xiàn	continuous and patient effort (idiom)
間斷	间断	jiàn duàn	disconnected/interrupted/suspended
阻斷	阻断	zǔ duàn	to block/to obstruct/to intercept/to interdict
隔斷	隔断	gé duàn	partition/to stand between/wall or fence serving as partition
隔斷板	隔断板	gé duàn bǎn	partition board
電腦斷層掃描	电脑断层扫描	diàn nǎo duàn céng sǎo miáo	CAT scan/CT scan
頹垣斷壁	颓垣断壁	tuí yuán duàn bì	crumbling fences and dilapidated walls (idiom)
風波不斷	风波不断	fēng bō bù duàn	constantly in turmoil/crisis after crisis
點斷式	点断式	diǎn duàn shì	designed to be torn off along a line of perforations
龍門山斷層	龙门山断层	Lóng mén shān duàn céng	Longmenshan fault line, a tectonically active thrust fault line at the northwest boundary of the Sichuan basin
龍門斷層	龙门断层	Lóng mén duàn céng	Longmenshan fault line, a tectonically active thrust fault line at the northwest boundary of the Sichuan basin
