錫	锡	xī	tin (chemistry)/to bestow/to confer/to grant/Taiwan pr. [xí]
察布查爾錫伯自治縣	察布查尔锡伯自治县	Chá bù chá ěr Xī bó Zì zhì xiàn	Qapqal Xibe autonomous county in Ili Kazakh autonomous prefecture 伊犁哈薩克自治州|伊犁哈萨克自治州[Yī lí Hā sà kè zì zhì zhōu], Xinjiang
拉瓦錫	拉瓦锡	Lā wǎ xī	Antoine Lavoisier (1743-1794), French nobleman and scientist, considered the father of modern chemistry
洛錫安區	洛锡安区	Luò Xī ān qū	Lothian, Scottish region around Edinburgh
游錫堃	游锡堃	Yóu Xī kūn	Yu Shyi-kun (1948-) Taiwanese politician
焊錫	焊锡	hàn xī	solder
無錫	无锡	Wú xī	Wuxi prefecture level city in Jiangsu
無錫市	无锡市	Wú xī shì	Wuxi prefecture level city in Jiangsu
無錫新區	无锡新区	Wú xī xīn qū	Wuxi new district of Wuxi city 無錫市|无锡市[Wú xī shì], Jiangsu
無錫縣	无锡县	Wú xī xiàn	Wuxi county in Jiangsu
萊比錫	莱比锡	Lái bǐ xī	Leipzig, city in the state of Saxony, Germany
貼錫箔	贴锡箔	tiē xī bó	to decorate with tin foil
金銀銅鐵錫	金银铜铁锡	jīn yín tóng tiě xī	the 5 metals: gold, silver, copper, iron and tin
劉禹錫	刘禹锡	Liú Yǔ xī	Liu Yuxi (772-842), Tang poet
錫伯	锡伯	Xī bó	Xibo ethnic group of northeast China
錫伯族	锡伯族	Xī bó zú	Xibo ethnic group of northeast China
錫克	锡克	Xī kè	Sikh
錫克教	锡克教	Xī kè jiào	Sikhism
錫劇	锡剧	Xī jù	Wuxi 無錫|无锡 opera
錫嘴雀	锡嘴雀	xī zuǐ què	(bird species of China) hawfinch (Coccothraustes coccothraustes)
錫婚	锡婚	xī hūn	tin anniversary/aluminum anniversary/10th wedding anniversary
錫安	锡安	Xī ān	Zion
錫安山	锡安山	Xī ān shān	Mount Zion
錫山	锡山	Xī shān	Xishan district of Wuxi city 無錫市|无锡市[Wú xī shì], Jiangsu
錫山區	锡山区	Xī shān qū	Xishan district of Wuxi city 無錫市|无锡市[Wú xī shì], Jiangsu
錫拉庫薩	锡拉库萨	Xī lā kù sà	Syracuse, Sicily
錫杖	锡杖	xī zhàng	monk's staff (Buddhism)
錫林浩特	锡林浩特	Xī lín hào tè	Xilinhaote city in Xilin Gol league 錫林郭勒盟|锡林郭勒盟[Xī lín guō lè méng], Inner Mongolia
錫林浩特市	锡林浩特市	Xī lín hào tè shì	Xilinhaote city in Xilin Gol league 錫林郭勒盟|锡林郭勒盟[Xī lín guō lè méng], Inner Mongolia
錫林郭勒	锡林郭勒	Xī lín guō lè	Xilin Gol league, a prefecture level subdivision of Inner Mongolia
錫林郭勒盟	锡林郭勒盟	Xī lín guō lè méng	Xilin Gol league, a prefecture level subdivision of Inner Mongolia
錫爾河	锡尔河	Xī ěr Hé	Syr Darya, Central Asian river, flowing from Kyrgiz Republic through Kazakhstan to the Aral sea
錫瓦	锡瓦	Xī wǎ	Siwa, Egypt
錫當河	锡当河	Xī dāng Hé	Sittang River of central Myanmar (Burma), between Irrawaddy and Salween rivers
錫石	锡石	xī shí	tin oxide SnO2/cassiterite/tinstone
錫礦	锡矿	xī kuàng	tin ore
錫箔	锡箔	xī bó	tinfoil
錫箔紙	锡箔纸	xī bó zhǐ	aluminum foil/CL:張|张[zhāng]
錫蘭	锡兰	Xī lán	Ceylon (former name of Sri Lanka)
錫蠟	锡蜡	xī là	pewter (alloy of tin 錫|锡, lead 鉛|铅 and other metals)
錫金	锡金	Xī jīn	Sikkim, Indian state bordering Tibet
錫鉛	锡铅	xī qiān	pewter (tin alloy)
錫錠	锡锭	xī dìng	tin ingot
錫鑞	锡镴	xī là	pewter (alloy of tin 錫|锡, lead 鉛|铅 and other metals)
錫霍特	锡霍特	Xī huò tè	Sichote-Alin mountain range in Russian far east opposite Sakhalin Island
錫霍特·阿林	锡霍特·阿林	Xī huò tè · Ā lín	Sichote-Alin mountain range in Russian far east opposite Sakhalin Island
錫霍特·阿林山脈	锡霍特·阿林山脉	Xī huò tè · Ā lín shān mài	Sichote-Alin mountain range in Russian far east opposite Sakhalin Island
錫霍特山脈	锡霍特山脉	Xī huò tè shān mài	Sichote-Alin mountain range in Russian far east opposite Sakhalin Island
閻錫山	阎锡山	Yán Xī shān	Yan Xishan (1883-1960), warlord in Shanxi
陳仁錫	陈仁锡	Chén Rén xī	Chen Renxi (1581-1636), late Ming scholar and prolific author
馬中錫	马中锡	Mǎ Zhōng xī	Ma Zhongxi, Ming writer (1446-1512), author of the fable The Wolf of Zhongshan 中山狼傳|中山狼传[Zhōng shān Láng Zhuàn]
麥肯錫	麦肯锡	Mài kěn xī	MacKenzie/McKinsey
