艾	艾	Ài	surname Ai
艾	艾	ài	Chinese mugwort or wormwood/moxa/to stop or cut short/phonetic "ai" or "i"/abbr. for 艾滋病[ài zī bìng], AIDS
艾	艾	yì	to mow/to cut/to reap/to redress
少艾	少艾	shào ài	young and pretty/pretty girl
布宜諾斯艾利斯	布宜诺斯艾利斯	Bù yí nuò sī Ài lì sī	Buenos Aires, capital of Argentina
怨艾	怨艾	yuàn yì	to resent/to regret/grudge
托馬斯·斯特恩斯·艾略特	托马斯·斯特恩斯·艾略特	Tuō mǎ sī · Sì tè ēn sī · Ài lüè tè	T. S. Eliot (1888-1965), English poet
方滋未艾	方滋未艾	fāng zī wèi ài	flourishing and still in the ascendant (idiom); rapidly expanding/still growing strong/on the up
方興未艾	方兴未艾	fāng xīng wèi ài	flourishing and still in the ascendant (idiom); rapidly expanding/still growing strong/on the up
期期艾艾	期期艾艾	qī qī ài ài	stammering (idiom)
未艾	未艾	wèi ài	(literary) not having come to its term
潔西卡·艾芭	洁西卡·艾芭	Jié xī kǎ · Ài bā	Jessica Alba, American actress
自怨自艾	自怨自艾	zì yuàn zì yì	to be full of remorse/to repent and redress one's errors
自艾自憐	自艾自怜	zì ài zì lián	to feel sorry for oneself
上艾瑟爾	上艾瑟尔	Shàng ài sè ěr	Overijssel
傑西卡·艾爾芭	杰西卡·艾尔芭	Jié xī kǎ · Ài ěr bā	Jessica Alba, American actress
大衛·艾登堡	大卫·艾登堡	Dà wèi · Ài dēng bǎo	David Attenborough (1926-), British naturalist and broadcaster, author of Life on Earth 地球上的生物[dì qiú shàng de shēng wù]
艾丁湖	艾丁湖	Ài dīng Hú	Ayding Lake (Aydingkol) in Xinjiang
艾伯塔	艾伯塔	Ài bó tǎ	Alberta province of Canada, capital Edmonton 埃德蒙頓|埃德蒙顿[Āi dé méng dùn]/also written 阿爾伯塔|阿尔伯塔[Ā ěr bó tǎ]
艾冬花	艾冬花	ài dōng huā	coltsfoot flower (used in TCM)/Flos Farfarae
艾卷	艾卷	ài juǎn	moxa cigar/moxa roll (TCM)
艾哈邁德	艾哈迈德	Ài hǎ mài dé	Ahmed (name)
艾哈邁迪內賈德	艾哈迈迪内贾德	Ài hā mài dí nèi jiǎ dé	Ahmadinejad or Ahmadinezhad (Persian name)/Mahmoud Ahmadinejad (1956-), Iranian fundamentalist politician, president of Iran 2005-2013
艾哈邁達巴德	艾哈迈达巴德	Ài hā mài dá bā dé	Ahmedabad, largest city in west Indian state Gujarat 古吉拉特[Gǔ jí lā tè]
艾塔	艾塔	ài tǎ	eta (Greek letter Ηη)
艾奇遜	艾奇逊	Ài qí xùn	Atchison or Acheson (name)/Atchison city on Missouri in Kansas, USA
艾奧瓦	艾奥瓦	Ài ào wǎ	Iowa, US state
艾奧瓦州	艾奥瓦州	Ài ào wǎ zhōu	Iowa, US state
艾實	艾实	ài shí	mugwort fruit (TCM)/also called fruit of argyi wormwood/Fructus Artemisiae argyi
艾彌爾	艾弥尔	Ài mí ěr	Emile (name)
艾德蒙頓	艾德蒙顿	Ài dé méng dùn	Edmonton, capital of Alberta, Canada/also written 埃德蒙頓|埃德蒙顿[Āi dé méng dùn]
艾德蕾德	艾德蕾德	Ài dé lěi dé	variant of 阿德萊德|阿德莱德, Adelaide, capital of South Australia
艾撲西龍	艾扑西龙	ài pū xī lóng	epsilon (Greek letter Εε)
艾未未	艾未未	Ài Wèi wèi	Ai Weiwei (1957-), Chinese artist active in architecture, photography, film, as well as cultural criticism and political activism
艾格尼絲·史沫特萊	艾格尼丝·史沫特莱	Ài gé ní sī · Shǐ mò tè lái	Agnes Smedley (1892-1950), US journalist who reported on China, esp. the communist side
艾條	艾条	ài tiáo	moxa stick, moxa roll (TCM)
艾條溫和灸	艾条温和灸	ài tiáo wēn hé jiǔ	gentle stick moxibustion (TCM)
艾條灸	艾条灸	ài tiáo jiǔ	stick moxibustion/poling (TCM)
艾條雀啄灸	艾条雀啄灸	ài tiáo què zhuó jiǔ	"sparrow pecking" moxibustion technique (TCM)
艾森豪威爾	艾森豪威尔	Ài sēn háo wēi ěr	Dwight D. Eisenhower (1890-1969), US army general and politician, Supreme Allied Commander in Europe during World War II, US President 1953-1961
艾比湖	艾比湖	Ài bǐ Hú	Aibi Lake (Ebinur) in Xinjiang
艾滋	艾滋	ài zī	AIDS (loanword)/see also 愛滋病|爱滋病[ài zī bìng]
艾滋病	艾滋病	ài zī bìng	AIDS (loanword)
艾滋病患者	艾滋病患者	ài zī bìng huàn zhě	AIDS patient
艾滋病抗體	艾滋病抗体	ài zī bìng kàng tǐ	AIDS antibody
艾滋病毒	艾滋病毒	ài zī bìng dú	human immune deficiency virus (HIV)/the AIDS virus
艾滋病病毒	艾滋病病毒	ài zī bìng bìng dú	HIV/see also 愛滋病毒|爱滋病毒[ài zī bìng dú]
艾灸	艾灸	ài jiǔ	moxibustion (TCM)
艾炭	艾炭	ài tàn	carbonized mugwort leaf (TCM)/Folium Artemisiae argyi carbonisatum
艾炷	艾炷	ài zhù	moxa cone
艾炷灸	艾炷灸	ài zhù jiǔ	cone moxibustion (TCM)
艾爾伯塔	艾尔伯塔	Ài ěr bó tǎ	Alberta province of Canada, capital Edmonton 埃德蒙頓|埃德蒙顿[Āi dé méng dùn]/also written 阿爾伯塔|阿尔伯塔[Ā ěr bó tǎ]
艾爾米塔什	艾尔米塔什	Ài ěr mǐ tǎ shí	Ermitazh or Hermitage museum in St Peterburg
艾爾米塔奇	艾尔米塔奇	Ài ěr mǐ tǎ jī	Ermitazh or Hermitage museum in St Peterburg
艾片	艾片	ài piàn	preparation obtained from sambong leaves, containing borneol (used in TCM)/Borneolum Luodian
艾特	艾特	ài tè	at symbol, @
艾瑞巴蒂	艾瑞巴蒂	ài ruì bā dì	(Internet slang) everybody (loanword)
艾瑪紐埃爾	艾玛纽埃尔	Ài mǎ niǔ āi ěr	Emmanuel or Emmanuelle (name)
艾登堡	艾登堡	Ài dēng bǎo	Attenborough (name)/David Attenborough (1926-), British naturalist and broadcaster, author of Life on Earth 地球上的生物[dì qiú shàng de shēng wù]
艾窩窩	艾窝窝	ài wō wo	glutinous rice cake with a sweet filling
艾納香	艾纳香	ài nà xiāng	sambong (Blumea balsamifera)
艾絨	艾绒	ài róng	moxa floss
艾美獎	艾美奖	Ài měi Jiǎng	Emmy Award
艾老	艾老	ài lǎo	(literary) person aged over fifty/elderly person
艾茲病	艾兹病	ài zī bìng	AIDS (loanword)/also written 愛滋病|爱滋病
艾草	艾草	ài cǎo	Asian mugwort or wormwood (genus Artemesia)
艾菲爾鐵塔	艾菲尔铁塔	Ài fēi ěr Tiě tǎ	Eiffel Tower
艾葉	艾叶	ài yè	mugwort leaf (TCM)/Folium Artemisiae argyi
艾葉油	艾叶油	ài yè yóu	mugwort leaf oil (TCM)/also called wormwood leaf oil/Oleum folii Artemisiae argyi
艾葉炭	艾叶炭	ài yè tàn	carbonized mugwort leaf (used in TCM)/Folium Artemisiae argyi carbonisatum
艾蒿	艾蒿	ài hāo	mugwort (Artemisia)
艾薩克	艾萨克	Ài sà kè	Isaac (name)
艾薩克·牛頓	艾萨克·牛顿	Ài sà kè · Niú dùn	Sir Isaac Newton (1642-1727), British mathematician and physicist
艾虎	艾虎	ài hǔ	see 艾鼬[ài yòu]
艾賽克斯	艾赛克斯	Ài sài kè sī	Essex (English county)
艾迪	艾迪	Ài dí	Eddie (name)
艾迪卡拉	艾迪卡拉	Ài dí kǎ lā	Ediacaran (c. 635-542 million years ago), late phase of pre-Cambrian geological era/also written 埃迪卡拉[Āi dí kǎ lā]
艾迪生	艾迪生	Ài dí shēng	Addison (name)/Addison, city in United States
艾酒	艾酒	ài jiǔ	wine flavored with Chinese mugwort
艾青	艾青	Ài Qīng	Ai Qing (1910-1996), Chinese poet
艾鼬	艾鼬	ài yòu	steppe polecat (Mustela eversmanii)
苦艾	苦艾	kǔ ài	wormwood/Artemisia absinthium
苦艾酒	苦艾酒	kǔ ài jiǔ	absinthe (distilled anise-based liquor)
萬艾可	万艾可	Wàn ài kě	Viagra
蘭艾同焚	兰艾同焚	lán ài tóng fén	lit. to burn both fragrant orchids and stinking weeds (idiom); fig. to destroy indiscriminately the noble and common/the rain falls on the just and unjust alike
防艾	防艾	fáng ài	protecting against AIDS
