花	花	Huā	surname Hua
花	花	huā	flower/blossom/CL:朵[duǒ],支[zhī],束[shù],把[bǎ],盆[pén],簇[cù]/fancy pattern/florid/to spend (money, time)/(coll.) lecherous/lustful
芲	花	huā	old variant of 花[huā]
蘤	花	huā	variant of 花[huā]/flower/blossom/also pr. [wěi]
亂花錢	乱花钱	luàn huā qián	to spend money recklessly/to squander
五花八門	五花八门	wǔ huā bā mén	myriad/all kinds of/all sorts of
五花大綁	五花大绑	wǔ huā dà bǎng	to bind a person's upper body, with arms tied behind the back and rope looped around the neck/to truss up
五花肉	五花肉	wǔ huā ròu	pork belly/streaky pork
五花醃豬肉	五花腌猪肉	wǔ huā yān zhū ròu	streaky bacon
供佛花	供佛花	gòng fó huā	flower offering
供花	供花	gòng huā	flower offering
借花獻佛	借花献佛	jiè huā xiàn Fó	lit. presenting the Buddha with borrowed flowers (idiom); fig. to win favor or influence using sb else's property/plagiarism
傍柳隨花	傍柳随花	bàng liǔ suí huā	prostitute
兩性花	两性花	liǎng xìng huā	hermaphrodite flower
冰花	冰花	bīng huā	ice crystal/frost (on windows)
冰葉日中花	冰叶日中花	bīng yè rì zhōng huā	ice plant (Mesembryanthemum crystallinum)
凌霄花	凌霄花	líng xiāo huā	Chinese trumpet vine (Campsis grandiflora)
凝花菜	凝花菜	níng huā cài	gelidiella, tropical and subtropical red algae
凹凸軋花	凹凸轧花	āo tū yà huā	embossing
刨花	刨花	bào huā	wood shavings
刨花板	刨花板	bào huā bǎn	particle board/chipboard
刺花	刺花	cì huā	to tattoo/tattoo
刺花紋	刺花纹	cì huā wén	to tattoo
劃花	划花	huà huā	engraving (on porcelain etc)
十字花科	十字花科	shí zì huā kē	Cruciferae or Brassicaceae (taxonomic family including Brassica etc whose flowers have a cross of 4 petals)
印花	印花	yìn huā	tax stamp
印花稅	印花税	yìn huā shuì	stamp duty
厚嘴啄花鳥	厚嘴啄花鸟	hòu zuǐ zhuó huā niǎo	(bird species of China) thick-billed flowerpecker (Dicaeum agile)
叫花子	叫花子	jiào huā zi	beggar
吊鐘花	吊钟花	diào zhōng huā	Chinese New Year flower (Enkianthus quinqueflorus)
同花	同花	tóng huā	flush (poker)
同花大順	同花大顺	tóng huā dà shùn	royal flush (poker)
同花順	同花顺	tóng huā shùn	straight flush (poker)
名花有主	名花有主	míng huā yǒu zhǔ	the girl is already taken (idiom)
向陽花	向阳花	xiàng yáng huā	sunflower
唐花	唐花	táng huā	hothouse flower (i.e. flower grown in a greenhouse)
啄花鳥	啄花鸟	zhuó huā niǎo	flowerpecker (any bird of the family Dicaeidae)
啤酒花	啤酒花	pí jiǔ huā	hops
喇叭花	喇叭花	lǎ ba huā	morning glory
國花	国花	guó huā	national flower (emblem, e.g. peony 牡丹[mǔ dān] in China)
團花	团花	tuán huā	rounded embroidery design
堂花	堂花	táng huā	variant of 唐花[táng huā]
報春花	报春花	bào chūn huā	primrose (Primula malacoides)
壓花	压花	yā huā	to emboss/coining/knurling
多栽花少栽刺	多栽花少栽刺	duō zāi huā shǎo zāi cì	talk nicely and avoid disputes/give compliments and not remarks
夜開花	夜开花	yè kāi huā	bottle gourd (i.e. 瓠瓜[hù guā])
大理花	大理花	dà lǐ huā	dahlia (loanword)
大麗花	大丽花	dà lì huā	dahlia (loanword)
天花	天花	tiān huā	smallpox/ceiling/stamen of corn/(old) snow/(dialect) sesame oil
天花亂墜	天花乱坠	tiān huā luàn zhuì	lit. a deluge of heavenly flowers (idiom)/fig. extravagant embellishments/hype
天花板	天花板	tiān huā bǎn	ceiling
天花病毒	天花病毒	tiān huā bìng dú	variola virus
太陽花	太阳花	tài yáng huā	sunflower (Helianthus annuus)/rose moss (Portulaca grandiflora)
奇花異卉	奇花异卉	qí huā yì huì	exotic flowers and rare herbs (idiom)
奇花異草	奇花异草	qí huā yì cǎo	very rarely seen, unusual (idiom)
奶油菜花	奶油菜花	nǎi yóu cài huā	creamed cauliflower
如花	如花	rú huā	flowery
如花似玉	如花似玉	rú huā sì yù	delicate as a flower, refined as a precious jade (idiom)/(of a woman) exquisite
妙筆生花	妙笔生花	miào bǐ shēng huā	gifted or skillful writing
姐妹花	姐妹花	jiě mèi huā	beautiful sisters
孽海花	孽海花	Niè hǎi huā	Flower in the sea of evil, late Qing novel by Jin Tianhe 金天翮[Jīn Tiān hé]
安祖花	安祖花	ān zǔ huā	flamingo lily (Anthurium andraeanum)
客西馬尼花園	客西马尼花园	Kè xī mǎ ní huā yuán	Garden of Gethsemane (in the Christian passion story)
家花沒有野花香	家花没有野花香	jiā huā méi yǒu yě huā xiāng	lit. the flowers in one's garden cannot match the fragrance of wild flowers (idiom)/fig. other women seem more attractive than one's own partner/the grass is always greener on the other side
尋花	寻花	xún huā	flower-viewing/to visit a prostitute
尋花問柳	寻花问柳	xún huā wèn liǔ	lit. to enjoy the beautiful spring scenery (idiom)/fig. to frequent brothels/to sow one's wild oats
小花遠志	小花远志	xiǎo huā yuǎn zhì	small-flowered milkwort (Polygala arvensis Willd. or P. telephioides), with roots used in Chinese medicine
小葵花鳳頭鸚鵡	小葵花凤头鹦鹉	xiǎo kuí huā fèng tóu yīng wǔ	(bird species of China) yellow-crested cockatoo (Cacatua sulphurea)
山茶花	山茶花	shān chá huā	camellia
幕後花絮	幕后花絮	mù hòu huā xù	news from behind the scenes/stage gossip
彈花	弹花	tán huā	to soften cotton fiber by fluffing
彼岸花	彼岸花	bǐ àn huā	red spider lily (Lycoris radiata)/cluster amaryllis
心花怒放	心花怒放	xīn huā nù fàng	to burst with joy (idiom)/to be over the moon/to be elated
惹草拈花	惹草拈花	rě cǎo niān huā	see 拈花惹草[niān huā rě cǎo]
惹草沾花	惹草沾花	rě cǎo zhān huā	see 沾花惹草[zhān huā rě cǎo]
拈花惹草	拈花惹草	niān huā rě cǎo	lit. to pick the flowers and trample the grass (idiom)/fig. to womanize/to frequent brothels/to sow one's wild oats
拷花	拷花	kǎo huā	to emboss
拼花地板	拼花地板	pīn huā dì bǎn	floor with tiled design
挑花	挑花	tiǎo huā	cross-stitch (embroidery)
挑花眼	挑花眼	tiǎo huā yǎn	(fig.) to get cross-eyed/to be bewildered
捧花	捧花	pěng huā	(wedding) bouquet
掛花	挂花	guà huā	to be wounded/(of plants) to bloom
採花	采花	cǎi huā	to pick flowers/to enter houses at night in order to rape women
採花大盜	采花大盗	cǎi huā dà dào	lit. flower thief/fig. rapist
採花賊	采花贼	cǎi huā zéi	lit. flower thief/fig. rapist
探花	探花	tàn huā	candidate who came third in the Han-lin examination/see 狀元|状元[zhuàng yuán]
提花	提花	tí huā	Jacquard weave (machine weaving leaving protruding pattern)
插花	插花	chā huā	flower arranging/ikebana
搞花樣	搞花样	gǎo huā yàng	to play tricks/to cheat/to deceive
搞花樣兒	搞花样儿	gǎo huā yàng r5	erhua variant of 搞花樣|搞花样[gǎo huā yàng]
擊鼓傳花	击鼓传花	jī gǔ chuán huā	beat the drum, pass the flower (game in which players sit in a circle passing a flower around while a drum is beaten – when the drumbeat stops, the player holding the flower must sing a song, answer a question, or drink a glass of wine etc)
擠花	挤花	jǐ huā	(cookery) to decorate using a piping bag/to extrude something though a piping bag/piping
擠花袋	挤花袋	jǐ huā dài	piping bag (cookery)
擺花架子	摆花架子	bǎi huā jià zi	lit. to arrange a shelf of flowers/superficial display (idiom)
攀枝花	攀枝花	Pān zhī huā	Panzhihua prefecture-level city in the south of Sichuan
攀枝花	攀枝花	pān zhī huā	kapok (tree)
攀枝花地區	攀枝花地区	Pān zhī huā dì qū	Panzhihua prefecture in south Sichuan, bordering Yunnan
攀枝花市	攀枝花市	Pān zhī huā shì	Panzhihua prefecture level city in south Sichuan, bordering Yunnan, famous for steel production and pollution
敗柳殘花	败柳残花	bài liǔ cán huā	broken flower, withered willow (idiom); fig. fallen woman
旋花科	旋花科	xuán huā kē	Convolvulaceae, herbaceous plant family
旋覆花	旋覆花	xuán fù huā	(botany) convolvulvus/Flos Inulae (Chinese herb)
明日黃花	明日黄花	míng rì huáng huā	lit. chrysanthemums after the Double Ninth Festival (idiom)/fig. outdated/thing of the past/dead letter
昏花	昏花	hūn huā	dim (eyesight)/blurred (vision)
易初蓮花	易初莲花	Yì chū Lián huā	Lotus (department store chain)
春江花月夜	春江花月夜	Chūn jiāng huā yuè yè	River on a spring night, long yuefu poem by 張若虛|张若虚[Zhāng Ruò xū]
暗花兒	暗花儿	àn huā r5	veiled design incised in porcelain or woven in fabric
曇花	昙花	tán huā	Dutchman's pipe cactus, aka Queen of the Night cactus (Epiphyllum oxypetalum)
曇花一現	昙花一现	tán huā yī xiàn	lit. the night-blooming cactus shows once/flash in the pan (idiom)/short-lived
月下花前	月下花前	yuè xià huā qián	lit. amidst the flowers under the moonlight (idiom)/fig. romantic surroundings
有意栽花花不發，無心插柳柳成陰	有意栽花花不发，无心插柳柳成阴	yǒu yì zāi huā huā bù fā , wú xīn chā liǔ liǔ chéng yīn	lit. you plant a garden and the flowers do not bloom, you poke a stick in the mud and it grows into a tree/fig. things do not always turn out as one would expect/well-laid plans may fail, and success may come where you least expect it
望花	望花	Wàng huā	Wanghua district of Fushun city 撫順市|抚顺市, Liaoning
望花區	望花区	Wàng huā qū	Wanghua district of Fushun city 撫順市|抚顺市, Liaoning
朝花夕拾	朝花夕拾	Zhāo huā xī shī	"Dawn Blossoms Plucked at Dusk", a collection of autobiographical essays by Lu Xun 魯迅|鲁迅[Lǔ Xùn]
木蘭花	木兰花	mù lán huā	magnolia
木魚花	木鱼花	mù yú huā	see 柴魚片|柴鱼片[chái yú piàn]
朱背啄花鳥	朱背啄花鸟	zhū bèi zhuó huā niǎo	(bird species of China) scarlet-backed flowerpecker (Dicaeum cruentatum)
杏花嶺	杏花岭	Xìng huā lǐng	Xinghualing district of Taiyuan city 太原市[Tài yuán shì], Shanxi
杏花嶺區	杏花岭区	Xìng huā lǐng qū	Xinghualing district of Taiyuan city 太原市[Tài yuán shì], Shanxi
杏花村	杏花村	xìng huā cūn	village of blossoming apricot trees where one can find a wineshop (reference to the famous poem 清明 by 杜牧[Dù Mù])
杜鵑花	杜鹃花	dù juān huā	Indian Azalea (Rhododendron simsii Planch)
杜鵑花科	杜鹃花科	dù juān huā kē	Ericaceae (botany), genus containing rhododendron and azalea
松花江	松花江	Sōng huā jiāng	Songhua River in Jilin province 吉林省 through Harbin 哈尔滨, a tributary of Heilongjiang 黑龍江|黑龙江
松花蛋	松花蛋	sōng huā dàn	thousand-year egg/preserved egg
柳啼花怨	柳啼花怨	liǔ tí huā yuàn	desolate
柳暗花明	柳暗花明	liǔ àn huā míng	lit. the willow trees make the shade, the flowers give the light (idiom); at one's darkest hour, a glimmer of hope/light at the end of the tunnel
柳煙花霧	柳烟花雾	liǔ yān huā wù	lit. willow scent and mist of blossom (idiom); scene full of the delights of spring
柳綠花紅	柳绿花红	liǔ lǜ huā hóng	green willow and red flowers/all the colors of spring
柳陌花衢	柳陌花衢	liǔ mò huā qú	brothel
校花	校花	xiào huā	the prettiest girl in the school (see also 校草[xiào cǎo])/school beauty queen/campus belle/prom queen
格子花呢	格子花呢	gé zi huā ní	tartan/plaid
桂花	桂花	guì huā	osmanthus flowers/Osmanthus fragrans
桃花	桃花	táo huā	peach blossom/(fig.) love affair
桃花心木	桃花心木	táo huā xīn mù	mahogany
桃花扇	桃花扇	Táo huā Shàn	The Peach Blossom Fan, historical play about the last days of the Ming dynasty by Kong Shangren 孔尚任[Kǒng Shàng rèn]
桃花水母	桃花水母	táo huā shuǐ mǔ	freshwater jellyfish (Craspedacusta)
桃花汛	桃花汛	táo huā xùn	spring flood (at peach-blossom time)
桃花源	桃花源	táo huā yuán	the Peach Blossom Spring, a hidden land of peace and prosperity/utopia
桃花運	桃花运	táo huā yùn	luck with the ladies/a romance/good luck
梅花	梅花	méi huā	plum blossom/clubs ♣ (a suit in card games)/wintersweet (dialect)
梅花拳	梅花拳	méi huā quán	Meihua Quan - "Plum Blossom Fist" (Chinese Martial Art)
梅花鹿	梅花鹿	méi huā lù	sika deer
梔子花	栀子花	zhī zi huā	cape jasmine (Gardenia jasminoides)
梨花帶雨	梨花带雨	lí huā dài yǔ	lit. like raindrops on a pear blossom (idiom)/fig. tear-stained face of a beauty
棉花	棉花	mián hua	cotton
棉花拳擊	棉花拳击	mián huā quán jī	Mianhua Quanji - "Cotton Boxing" (Chinese Martial Art)
棉花棒	棉花棒	mián huā bàng	cotton swab/cotton bud
棉花糖	棉花糖	mián huā táng	cotton candy/candyfloss/marshmallow
椰菜花	椰菜花	yē cài huā	cauliflower (Brassica oleracea var. botrytis)
樂開花	乐开花	lè kāi huā	to burst with joy
樹上開花	树上开花	shù shàng kāi huā	to deck the tree with false blossoms/to make something of no value appear valuable (idiom)
檵花	檵花	jì huā	fringe flower (Loropetalum chinense), evergreen shrub
檻花籠鶴	槛花笼鹤	jiàn huā lóng hè	a flower in a cage, a crane in a basket (idiom); prisoner
櫻花	樱花	yīng huā	oriental cherry (Prunus serrulata or Prunus yedoensis), prized for its blossom/also known as sakura (Japanese) or Yoshino cherry
櫻花妹	樱花妹	yīng huā mèi	(coll.) Japanese girl
櫻花草	樱花草	yīng huā cǎo	primrose
殘花敗柳	残花败柳	cán huā bài liǔ	broken flower, withered willow (idiom); fig. fallen woman
水仙花	水仙花	shuǐ xiān huā	daffodil/narcissus/CL:棵[kē]
水性楊花	水性杨花	shuǐ xìng yáng huā	fickle (woman)
水花	水花	shuǐ huā	splash/algal bloom/chickenpox (dialect)
沐浴花	沐浴花	mù yù huā	shower puff/shower sponge
油花	油花	yóu huā	grease or fat blobs at the surface of a liquid/tricky and dissolute
沾花惹草	沾花惹草	zhān huā rě cǎo	to fondle the flowers and trample the grass (idiom)/to womanize/to frequent brothels/to sow one's wild oats
洛神花	洛神花	luò shén huā	roselle (Hibiscus sabdariffa)
洞房花燭	洞房花烛	dòng fáng huā zhú	bridal room and ornamented candles/wedding festivities (idiom)
洞房花燭夜	洞房花烛夜	dòng fáng huā zhú yè	wedding night
浪花	浪花	làng huā	spray/ocean spray/spindrift/fig. happenings from one's life/CL:朵[duǒ]
浴花	浴花	yù huā	shower puff/shower sponge
海上花列傳	海上花列传	Hǎi shàng Huā Liè zhuàn	The Sing-Song Girls of Shanghai by Han Bangqing 韓邦慶|韩邦庆[Hán Bāng qìng], long novel of lower life in Classical Chinese and Jiangsu vernacular/translated into Putonghua as 海上花 by Iris Chang
海棠花	海棠花	hǎi táng huā	Chinese flowering crab-apple (Malus spectabilis)
淚花	泪花	lèi huā	tears in the eyes
湖北花楸	湖北花楸	Hú běi huā qiū	Chinese Rowan tree/Sorbus hupehensis or Hupeh rowan
滿臉生花	满脸生花	mǎn liǎn shēng huā	all smiles/beaming from ear to ear
潑煙花	泼烟花	pō yān huā	low-class prostitute
澆花	浇花	jiāo huā	to water the plants/to water the garden
火樹銀花	火树银花	huǒ shù yín huā	display of fireworks and lanterns
火花	火花	huǒ huā	spark/sparkle
火花塞	火花塞	huǒ huā sāi	spark plug
火鶴花	火鹤花	huǒ hè huā	flamingo lily (Anthurium andraeanum)
無花果	无花果	wú huā guǒ	fig (Ficus carica)
煙花	烟花	yān huā	fireworks/prostitute (esp. in Yuan theater)
煙花債	烟花债	yān huā zhài	involved in a love affair
煙花場	烟花场	yān huā chǎng	brothel (esp. in Yuan theater)
煙花女	烟花女	yān huā nǚ	prostitute (esp. in Yuan theater)
煙花寨	烟花寨	yān huā zhài	brothel (esp. in Yuan theater)
煙花巷	烟花巷	yān huā xiàng	red-light district
煙花市	烟花市	yān huā shì	(old) red-light district/brothel
煙花廠	烟花厂	yān huā chǎng	firework factory
煙花柳巷	烟花柳巷	yān huā liǔ xiàng	red-light district
煙花簿	烟花簿	yān huā bù	catalog of prostitutes (esp. in Yuan theater)
煙花粉黛	烟花粉黛	yān huā fěn dài	woman/prostitute/lovemaking/literary or theatrical form in Tang, Song and Yuan
煙花行院	烟花行院	yān huā xíng yuàn	brothel (esp. in Yuan theater)
煙花陣	烟花阵	yān huā zhèn	brothel (esp. in Yuan theater)
煙花風月	烟花风月	yān huā fēng yuè	refers to lovemaking (idiom)
燈籠花	灯笼花	dēng lóng huā	Chinese enkianthus
爆玉米花	爆玉米花	bào yù mǐ huā	to make popcorn/popcorn
爆米花	爆米花	bào mǐ huā	puffed rice/popcorn
爆花	爆花	bào huā	see 爆米花[bào mǐ huā]
爆菊花	爆菊花	bào jú huā	(slang) to stick sth up the anus/to have anal intercourse
爛桃花	烂桃花	làn táo huā	unhappy love affair
片花	片花	piàn huā	trailer (for a movie)
牽牛花	牵牛花	qiān niú huā	white-edged morning glory
獻花	献花	xiàn huā	to offer flowers/to lay flowers (as a memorial)
玉米花	玉米花	yù mǐ huā	popcorn
玉蘭花	玉兰花	yù lán huā	magnolia
玩兒花招	玩儿花招	wán r5 huā zhāo	to play tricks
玩花招	玩花招	wán huā zhāo	to play tricks
玫瑰花	玫瑰花	méi guī huā	rose
班花	班花	bān huā	the prettiest girl in the class
生花妙筆	生花妙笔	shēng huā miào bǐ	beautiful or talented writing
番紅花	番红花	fān hóng huā	saffron (Crocus sativus)
白花花	白花花	bái huā huā	shining white
白花蛇	白花蛇	bái huā shé	long-nosed pit viper (agkistrodon acutus)
白花蛇舌草	白花蛇舌草	bái huā shé shé cǎo	Hedyotis diffusa
百合花	百合花	bǎi hé huā	lily/fig. pure and spotless person/virgin
百合花飾	百合花饰	bǎi hé huā shì	fleur-de-lis (armorial symbol)
百花園	百花园	Bǎi huā yuán	Garden of Many Flowers (name)/Baihua garden in Hongmiao village 洪廟村|洪庙村[Hóng miào cūn], Shandong
百花獎	百花奖	bǎi huā jiǎng	Hundred flowers film prize, awarded since 1962
百花運動	百花运动	Bǎi huā Yùn dòng	Hundred Flowers Campaign (PRC, 1956-57), in which Mao called for the taboo on discussing mistakes of the CCP to be lifted
百花齊放	百花齐放	bǎi huā qí fàng	a hundred flowers bloom (idiom); let the arts have free expression
百花齊放，百家爭鳴	百花齐放，百家争鸣	bǎi huā qí fàng , bǎi jiā zhēng míng	a hundred flowers bloom, a hundred schools of thought contend (idiom); refers to the classical philosophic schools of the Warring States period 475-221 BC, but adopted for Mao's campaign of 1956
百金花	百金花	bǎi jīn huā	Centaurium pulchellum var. altaicum
盆花	盆花	pén huā	potted flower
看花眼	看花眼	kān huā yǎn	to be dazzled/to not believe one's own eyes
眼花	眼花	yǎn huā	dimmed eyesight/blurred/vague and unclear vision
眼花繚亂	眼花缭乱	yǎn huā liáo luàn	to be dazzled
矮腳白花蛇利草	矮脚白花蛇利草	ǎi jiǎo bái huā shé lì cǎo	see 白花蛇舌草[bái huā shé shé cǎo]
石南花	石南花	shī nán huā	heather (Ericaceae)
石花菜	石花菜	shí huā cài	seaweed (Gelidium amansii)/Japanese Isinglass
禮花	礼花	lǐ huā	fireworks
移花接木	移花接木	yí huā jiē mù	lit. to graft flowers onto a tree/to surreptitiously substitute one thing for another (idiom)
種花	种花	zhòng huā	to grow flowers/floriculture
空中花園	空中花园	kōng zhōng huā yuán	hanging gardens (Babylon etc)/rooftop garden
窗花	窗花	chuāng huā	paper cutting
童花頭	童花头	tóng huā tóu	short bobbed hairstyle
筆下生花	笔下生花	bǐ xià shēng huā	to write elegantly
紅梅花雀	红梅花雀	hóng méi huā què	(bird species of China) red avadavat (Amandava amandava)
紅胸啄花鳥	红胸啄花鸟	hóng xiōng zhuó huā niǎo	(bird species of China) fire-breasted flowerpecker (Dicaeum ignipectus)
紅花	红花	hóng huā	safflower (Carthamus tinctorius)
紅花崗	红花岗	Hóng huā gǎng	Honghua district of Zunyi city 遵義市|遵义市[Zūn yì shì], Guizhou
紅花崗區	红花岗区	Hóng huā gǎng qū	Honghua district of Zunyi city 遵義市|遵义市[Zūn yì shì], Guizhou
純色啄花鳥	纯色啄花鸟	chún sè zhuó huā niǎo	(bird species of China) plain flowerpecker (Dicaeum minullum)
紙花	纸花	zhǐ huā	paper flower
紫色花蜜鳥	紫色花蜜鸟	zǐ sè huā mì niǎo	(bird species of China) purple sunbird (Cinnyris asiaticus)
紫花地丁	紫花地丁	zǐ huā dì dīng	Chinese violet (Viola mandsurica)
紫錐花	紫锥花	zǐ zhuī huā	coneflower genus (Echinacea)
經絲彩色顯花	经丝彩色显花	jīng sī cǎi sè xiǎn huā	warp brocade/woven fabric with single woof but colored warp
綠壩·花季護航	绿坝·花季护航	Lǜ bà · huā jì hù háng	Green Dam Youth Escort, Internet content-control software (abbreviated to 綠壩|绿坝[Lǜ bà])
綠花椰菜	绿花椰菜	lǜ huā yē cài	broccoli
綠花菜	绿花菜	lǜ huā cài	broccoli
綠菜花	绿菜花	lǜ cài huā	broccoli
繁花	繁花	fán huā	flourishing blossom/a mass of flowers/luxuriant flowers
織花	织花	zhī huā	woven pattern
繡球花	绣球花	xiù qiú huā	hydrangea
繡花	绣花	xiù huā	to embroider/to do embroidery
繡花鞋	绣花鞋	xiù huā xié	embroidered shoes
群花	群花	qún huā	blossom
羯鼓催花	羯鼓催花	jié gǔ cuī huā	drumming to make apricots flower, cf joke by Tang Emperor Xuanzhong 唐玄宗, playing the drum in apricot blossom
老眼昏花	老眼昏花	lǎo yǎn hūn huā	blurred vision of an old person (idiom)
老花	老花	lǎo huā	presbyopia
老花眼	老花眼	lǎo huā yǎn	presbyopia
老花鏡	老花镜	lǎo huā jìng	presbyopic glasses
耍花招	耍花招	shuǎ huā zhāo	to play tricks on sb
耍花槍	耍花枪	shuǎ huā qiāng	to play tricks/to dupe
耍花樣	耍花样	shuǎ huā yàng	to play tricks on sb
聖誕花	圣诞花	shèng dàn huā	poinsettia (Euphorbia pulcherrima)
胡姬花	胡姬花	hú jī huā	Vanda miss joaquim (hybrid orchid), national flower of Singapore
胡花	胡花	hú huā	to spend recklessly/to squander money
胸花	胸花	xiōng huā	corsage/boutonnière
腦袋開花	脑袋开花	nǎo dài kāi huā	to blow one's brain out
艾冬花	艾冬花	ài dōng huā	coltsfoot flower (used in TCM)/Flos Farfarae
芙蓉花	芙蓉花	fú róng huā	cotton rose hibiscus (Hibiscus mutabilis)/lotus
芫花	芫花	yuán huā	lilac daphne/Daphne genkwa
芫花素	芫花素	yuán huā sù	genkwanin
下花園	下花园	Xià huā yuán	Xiahua district of Zhangjiakou city 張家口市|张家口市[Zhāng jiā kǒu shì], Hebei
下花園區	下花园区	Xià huā yuán qū	Xiahua district of Zhangjiakou city 張家口市|张家口市[Zhāng jiā kǒu shì], Hebei
花不稜登	花不棱登	huā bù léng dēng	gaudy/repulsively colored
花俏	花俏	huā qiào	fancy/gaudy
花光	花光	huā guāng	to spend all one's money
花兒	花儿	huā ér	style of folk song popular in Gansu, Qinghai and Ningxia/CL:首[shǒu]
花兒	花儿	huā r5	erhua variant of 花[huā]
花冠	花冠	huā guān	corolla
花冠皺盔犀鳥	花冠皱盔犀鸟	huā guān zhòu kuī xī niǎo	(bird species of China) wreathed hornbill (Rhyticeros undulatus)
花前月下	花前月下	huā qián yuè xià	see 月下花前[yuè xià huā qián]
花劍	花剑	huā jiàn	foil (fencing)
花匠	花匠	huā jiàng	gardener
花卉	花卉	huā huì	flowers and plants
花卷	花卷	huā juǎn	Chinese steamed twisted bread roll
花叢	花丛	huā cóng	cluster of flowers/inflorescence/flowering shrub
花名	花名	huā míng	name of a person on the household register (old)/name on a roster/professional name of a prostitute/pseudonym/nickname
花呢	花呢	huā ní	tweed/checkered cloth
花哨	花哨	huā shao	garish/gaudy
花唄	花呗	Huā bei	Ant Check Later, consumer credit service offered by Ant Financial Services 螞蟻金服|蚂蚁金服[Mǎ yǐ Jīn fú]
花商	花商	huā shāng	florist
花圃	花圃	huā pǔ	flowerbed/parterre
花圈	花圈	huā quān	wreath/garland
花園	花园	huā yuán	garden/CL:座[zuò],個|个[gè]
花園鞋	花园鞋	huā yuán xié	Crocs shoes (or any similar shoe)
花團錦簇	花团锦簇	huā tuán jǐn cù	brightly colored decorations (idiom)/splendid
花地瑪堂區	花地玛堂区	Huā dì mǎ táng qū	Parish of Our Lady of Fatima (Macau)/Freguesia de Nossa Senhora de Fátima
花垣	花垣	Huā yuán	Huayuan county in Xiangxi Tujia and Miao autonomous prefecture 湘西土家族苗族自治州[Xiāng xī Tǔ jiā zú Miáo zú zì zhì zhōu]
花垣縣	花垣县	Huā yuán xiàn	Huayuan county in Xiangxi Tujia and Miao autonomous prefecture 湘西土家族苗族自治州[Xiāng xī Tǔ jiā zú Miáo zú zì zhì zhōu]
花壇	花坛	Huā tán	Huatan township in Changhua county 彰化縣|彰化县[Zhāng huà xiàn], Taiwan
花壇	花坛	huā tán	decorative mass planting of flowers and shrubs, often bounded by a low masonry border, and often part of a streetscape
花壇鄉	花坛乡	Huā tán xiāng	Huatan township in Changhua county 彰化縣|彰化县[Zhāng huà xiàn], Taiwan
花大姐	花大姐	huā dà jiě	common word for ladybug, more formally 瓢虫
花天酒地	花天酒地	huā tiān jiǔ dì	to spend one's time in drinking and pleasure (idiom); to indulge in sensual pleasures/life of debauchery
花好月圓	花好月圆	huā hǎo yuè yuán	lit. lovely flowers, round moon (idiom); fig. everything is wonderful/perfect happiness/conjugal bliss
花子	花子	huā zi	beggar (old term)
花季	花季	huā jì	youthful time/prime of youth/flowering season
花容月貌	花容月貌	huā róng yuè mào	lit. countenance of a flower, face like the moon (idiom)/fig. (of a woman) beautiful
花尾榛雞	花尾榛鸡	huā wěi zhēn jī	(bird species of China) hazel grouse (Tetrastes bonasia)
花展	花展	huā zhǎn	flower show
花山	花山	Huā shān	Huashan district of Ma'anshan city 馬鞍山市|马鞍山市[Mǎ ān shān shì], Anhui
花山區	花山区	Huā shān qū	Huashan district of Ma'anshan city 馬鞍山市|马鞍山市[Mǎ ān shān shì], Anhui
花崗岩	花岗岩	huā gāng yán	granite
花崗石	花岗石	huā gāng shí	granite
花巧	花巧	huā qiǎo	fancy
花布	花布	huā bù	printed cloth/calico
花床	花床	huā chuáng	flower bed
花序	花序	huā xù	inflorescence/flower cluster
花店	花店	huā diàn	flower shop
花廳	花厅	huā tīng	reception pavilion (generally part of a large residence, and often built in a garden)
花式	花式	huā shì	fancy
花式游泳	花式游泳	huā shì yóu yǒng	synchronized swimming
花式溜冰	花式溜冰	huā shì liū bīng	figure skating
花式足球	花式足球	huā shì zú qiú	freestyle soccer
花彩	花彩	huā cǎi	to festoon/to decorate with a row of colored garlands
花彩雀鶯	花彩雀莺	huā cǎi què yīng	(bird species of China) white-browed tit-warbler (Leptopoecile sophiae)
花心	花心	huā xīn	fickle (in love affairs)/dissipated/unfaithful/heart of a flower (pistil and stamen)
花心大蘿蔔	花心大萝卜	huā xīn dà luó bo	(coll.) womanizer/skirt-chaser
花心思	花心思	huā xīn sī	to think through/to invest effort in thinking about/to consider thoroughly
花戶	花户	huā hù	registered occupants of a house
花房	花房	huā fáng	greenhouse
花托	花托	huā tuō	receptacle (base of flower)
花把勢	花把势	huā bǎ shì	expert flower grower
花把式	花把式	huā bǎ shì	expert flower grower
花押	花押	huā yā	signature (in grass-style writing)/symbol used in place of a signature (on a document, contract etc)
花招	花招	huā zhāo	trick/maneuver/razzle-dazzle/(martial arts) fancy move/flourish
花括號	花括号	huā kuò hào	braces/curly brackets { }
花拳	花拳	huā quán	showy boxing of no practical use/see 花拳繡腿|花拳绣腿
花拳繡腿	花拳绣腿	huā quán xiù tuǐ	flowery of fist with fancy footwork (idiom)/highly embellished and ineffectual/fancy but impractical skills/all show and no go/pugilistic wankery
花掉	花掉	huā diào	to spend (time, money)/to waste
花斑	花斑	huā bān	patches/mottling
花斑癬	花斑癣	huā bān xuǎn	pityriasis versicolor (aka tinea versicolor), blotchy skin condition common in tropical areas, common name 汗斑
花旗	花旗	huā qí	the Stars and Stripes (US flag)/by extension, the United States of America/abbr. for Citibank 花旗銀行|花旗银行
花旗參	花旗参	huā qí shēn	American ginseng
花旗國	花旗国	huā qí guó	USA (land of the stars and stripes)
花旗銀行	花旗银行	Huā qí Yín háng	Citibank/abbr. to 花旗
花旦	花旦	huā dàn	role of vivacious young female in Chinese opera
花時間	花时间	huā shí jiān	to take up time/to spend time
花會	花会	huā huì	flower fair or festival
花有重開日，人無再少年	花有重开日，人无再少年	huā yǒu chóng kāi rì , rén wú zài shào nián	a flower may blossom again, but a person cannot get young again (proverb)
花朝月夕	花朝月夕	huā zhāo yuè xī	a beautiful day/cf Birthday of the Flowers on lunar 15th February and Mid-autumn Festival on lunar 15th August
花朝節	花朝节	huā zhāo jié	Birthday of the Flowers, spring festival on lunar 12th or 15th February
花期	花期	huā qī	the flowering season
花木	花木	huā mù	flowers and trees/plants/flora
花木蘭	花木兰	Huā Mù lán	Hua Mulan, legendary woman warrior (c. fifth century), Northern dynasties folk hero recorded in Sui and Tang literature
花朵	花朵	huā duǒ	flower
花束	花束	huā shù	bouquet
花果山	花果山	Huā guǒ Shān	Mount Huaguo in Jiangsu, featured in 西遊記|西游记[Xī yóu Jì], tourist destination/(also the name of mountains in other parts of China)
花枝	花枝	huā zhī	spray (sprig of a plant with blossoms)/cuttlefish (on dining menus)/(literary) beautiful woman
花枝招展	花枝招展	huā zhī zhāo zhǎn	lit. lovely scene of blossoming plants swaying in the breeze (idiom)/fig. gorgeously dressed (woman)
花架子	花架子	huā jià zi	attractive appearance, but without substance
花柱	花柱	huā zhù	style (female organ of flower)
花柳病	花柳病	huā liǔ bìng	sexually transmitted disease/venereal disease
花栗鼠	花栗鼠	huā lì shǔ	chipmunk (genus Tamias)
花梗	花梗	huā gěng	stem of flower
花椒	花椒	huā jiāo	Sichuan pepper/Chinese prickly ash
花椰菜	花椰菜	huā yē cài	cauliflower
花槍	花枪	huā qiāng	short spear (arch.)/fig. trickery
花樣	花样	huā yàng	pattern/way of doing sth/trick/(sports) fancy-style (as figure skating etc)
花樣年華	花样年华	huā yàng nián huá	the prime of life
花樣游泳	花样游泳	huā yàng yóu yǒng	synchronized swimming
花樣滑冰	花样滑冰	huā yàng huá bīng	figure skating
花池子	花池子	huā chí zi	flower bed
花活	花活	huā huó	trick/deception
花溪	花溪	Huā xī	Huaxi district of Guiyang city 貴陽市|贵阳市[Guì yáng shì], Guizhou
花溪區	花溪区	Huā xī qū	Huaxi district of Guiyang city 貴陽市|贵阳市[Guì yáng shì], Guizhou
花灑	花洒	huā sǎ	sprinkler/shower
花火	花火	huā huǒ	firework
花炮	花炮	huā pào	firecracker
花無百日紅	花无百日红	huā wú bǎi rì hóng	No flower can bloom for a hundred days./Good times do not last long. (idiom)
花燈	花灯	huā dēng	colored lantern (used at Lantern Festival 元宵節|元宵节)
花燈戲	花灯戏	huā dēng xì	opera for popular in Sichuan and Yunnan
花環	花环	huā huán	garland/floral hoop
花瓣	花瓣	huā bàn	petal/CL:片[piàn]
花瓶	花瓶	huā píng	flower vase/fig. just a pretty face/CL:對|对[duì]
花生	花生	huā shēng	peanut/groundnut/CL:粒[lì]
花生漿	花生浆	huā shēng jiàng	peanut butter/also written 花生醬|花生酱
花生秀	花生秀	huā shēng xiù	fashion show (loanword)
花生米	花生米	huā shēng mǐ	shelled peanuts
花生醬	花生酱	huā shēng jiàng	peanut butter
花用	花用	huā yòng	to spend (money)
花田雞	花田鸡	huā tián jī	(bird species of China) Swinhoe's rail (Coturnicops exquisitus)
花甲	花甲	huā jiǎ	complete sexagenary cycle/a 60 year-old person/passage of time
花痴	花痴	huā chī	to be smitten with sb/love-struck fool/starry-eyed infatuation
花白	花白	huā bái	grizzled (hair)
花盆	花盆	huā pén	flower pot
花石	花石	huā shí	marble
花石峽	花石峡	Huā shí xiá	Huashixia town in Madoi county 瑪多縣|玛多县[Mǎ duō xiàn] in Golog Tibetan autonomous prefecture, Qinghai
花石峽鎮	花石峡镇	Huā shí xiá zhèn	Huashixia town in Madoi county 瑪多縣|玛多县[Mǎ duō xiàn] in Golog Tibetan autonomous prefecture, Qinghai
花童	花童	huā tóng	page boy/flower girl (at a wedding)
花簇	花簇	huā cù	bunch of flowers/bouquet
花粉	花粉	huā fěn	pollen
花粉熱	花粉热	huā fěn rè	hay fever
花粉症	花粉症	huā fěn zhèng	hay fever/seasonal allergic rhinitis
花粉過敏	花粉过敏	huā fěn guò mǐn	hay fever
花紅	花红	huā hóng	flowers on red silk (a traditional gift to celebrate weddings etc)/a bonus/crab apple (Malus asiatica)
花紅柳綠	花红柳绿	huā hóng liǔ lǜ	red flowers and green willow/all the colors of spring
花紋	花纹	huā wén	decorative design
花結	花结	huā jié	decorative bow of ribbon or fabric
花絮	花絮	huā xù	bits of news/interesting sidelights
花絲	花丝	huā sī	stalk (filament) of stamen
花緞	花缎	huā duàn	brocade/figured satin
花肥	花肥	huā féi	fertilizer for potted flowers/fertilizer used to promote flowering in crop plants
花腔	花腔	huā qiāng	florid ornamentation in opera/coloratura
花腹綠啄木鳥	花腹绿啄木鸟	huā fù lǜ zhuó mù niǎo	(bird species of China) laced woodpecker (Picus vittatus)
花臉鴨	花脸鸭	huā liǎn yā	(bird species of China) Baikal teal (Anas formosa)
花臺	花台	huā tái	flower bed/flower terrace/flower stand
花色	花色	huā sè	variety/design and color/suit (cards)
花色素	花色素	huā sè sù	anthocyanidin (biochemistry)
花色素苷	花色素苷	huā sè sù gān	anthocyanin (biochemistry)
花花世界	花花世界	huā huā shì jiè	the teeming world/the world of sensual pleasures
花花公主	花花公主	huā huā gōng zhǔ	playgirl
花花公子	花花公子	huā huā gōng zǐ	playboy
花花搭搭	花花搭搭	huā hua dā dā	mixed/uneven in texture
花花綠綠	花花绿绿	huā huā lǜ lǜ	brightly colored/gaudy
花花腸子	花花肠子	huā huā cháng zi	(slang) a cunning plot
花苞	花苞	huā bāo	flower bud
花茶	花茶	huā chá	scented tea/CL:杯[bēi],壺|壶[hú]
花草	花草	huā cǎo	flowers and plants
花菜	花菜	huā cài	cauliflower
花萼	花萼	huā è	sepal
花著	花着	huā zhāo	variant of 花招[huā zhāo]
花蓮	花莲	Huā lián	Hualien, city and county on the east coast of Taiwan
花蓮市	花莲市	Huā lián shì	Hualien city on the east coast of Taiwan
花蓮縣	花莲县	Huā lián Xiàn	Hualien County on the east coast of Taiwan
花蕊	花蕊	huā ruǐ	stamen/pistil
花蕾	花蕾	huā lěi	bud/flower bud
花藥	花药	huā yào	anther (pollen sack on stamen)
花蛤	花蛤	huā gé	clam/bivalve mollusk, many spp.
花蜜	花蜜	huā mì	nectar
花蟒	花蟒	huā mǎng	python
花街	花街	huā jiē	red-light district
花被	花被	huā bèi	perianth (common term for calyx and corolla)/border and protecting envelope of a flower
花裡胡哨	花里胡哨	huā li hú shào	gaudy/flashy (but without substance)
花言巧語	花言巧语	huā yán qiǎo yǔ	graceful words, flowery speech (idiom); elegant but insincere words/cheating wheedling/dishonest rhetoric
花豹	花豹	huā bào	leopard/CL:隻|只[zhī]
花貌蓬心	花貌蓬心	huā mào péng xīn	florid outside appearance, unkempt interior (idiom)
花費	花费	huā fèi	expense/cost/to spend (time or money)/expenditure
花車	花车	huā chē	car festooned for celebration
花轎	花轿	huā jiào	bridal sedan chair
花農	花农	huā nóng	flower grower
花邊	花边	huā biān	lace/decorative border
花邊人物	花边人物	huā biān rén wù	smooth talker/fast talker/slick and sociable person/person in the news
花邊兒	花边儿	huā biān r5	erhua variant of 花邊|花边[huā biān]
花邊新聞	花边新闻	huā biān xīn wén	media gossip/sensational news
花都	花都	Huā dū	Huadu district of Guangzhou city 廣州市|广州市[Guǎng zhōu shì], Guangdong
花都區	花都区	Huā dū qū	Huadu district of Guangzhou city 廣州市|广州市[Guǎng zhōu shì], Guangdong
花酒	花酒	huā jiǔ	drinking party with female entertainers
花銷	花销	huā xiāo	to spend (money)/expenses
花錢	花钱	huā qián	to spend money
花錢受氣	花钱受气	huā qián shòu qì	(idiom) to have a bad experience as a customer/to encounter poor service
花錢找罪受	花钱找罪受	huā qián zhǎo zuì shòu	to spend money on sth that turns out to be unsatisfactory or even disastrous
花雕	花雕	huā diāo	Shaoxing yellow wine
花雞	花鸡	huā jī	chaffinch (family Fringillidae)
花露水	花露水	huā lù shuǐ	perfumed toilet water/eau de cologne/floral water/hydrosol
花青素	花青素	huā qīng sù	anthocyanidin (biochemistry)
花頭	花头	huā tou	trick/pattern/novel idea/knack
花頭鸚鵡	花头鹦鹉	huā tóu yīng wǔ	(bird species of China) blossom-headed parakeet (Psittacula roseata)
花飾	花饰	huā shì	floral decoration/ornament/floral pattern
花香	花香	huā xiāng	fragrance of flowers
花骨朵	花骨朵	huā gǔ duo	(coll.) flower bud
花魁	花魁	huā kuí	the queen of flowers (refers esp. to plum blossom)/(fig.) nickname for a famous beauty or courtesan
花鰱	花鲢	huā lián	see 鱅魚|鳙鱼[yōng yú]
花鳥	花鸟	huā niǎo	painting of birds and flowers
花黃	花黄	huā huáng	yellow flower (cosmetic powder used on women's forehead in former times)
花點子	花点子	huā diǎn zi	trickery/scam
花鼓	花鼓	huā gǔ	flower drum, a type of double-skinned Chinese drum/folk dance popular in provinces around the middle reaches of the Yangtze/(bicycle wheel) hub
花鼓戲	花鼓戏	huā gǔ xì	opera form popular along Changjiang
世外桃花源	世外桃花源	shì wài táo huā yuán	see 桃花源[táo huā yuán]
苦菜花	苦菜花	Kǔ Cài huā	Bitter Cauliflower, 1954 socialist realist novel by Feng Deying 馮德英|冯德英[Féng Dé yīng] loosely based on Maxim Gorky's Mother, made into a 1967 film by Li Ang
茉莉花	茉莉花	mò li huā	jasmine
茉莉花茶	茉莉花茶	mò li huā chá	jasmine tea
茶花	茶花	chá huā	camellia
荷花	荷花	hé huā	lotus
菊花	菊花	jú huā	chrysanthemum/(slang) anus
菊花茶	菊花茶	jú huā chá	chrysanthemum tea
菜花	菜花	cài huā	cauliflower/gonorrhea
菱花鏡	菱花镜	líng huā jìng	antique bronze mirror with flower petal edging, most commonly from the Tang dynasty
萬花筒	万花筒	wàn huā tǒng	kaleidoscope
落花有意，流水無情	落花有意，流水无情	luò huā yǒu yì , liú shuǐ wú qíng	lit. the falling flowers are yearning for love, but the heartless brook ripples on (idiom)/fig. one side is willing, yet the other one remains indifferent (usually of unrequited love)
落花流水	落花流水	luò huā liú shuǐ	to be in a sorry state/to be utterly defeated
落花生	落花生	luò huā shēng	peanut
著花	着花	zháo huā	to blossom/to come to flower/to be in bloom
著花	着花	zhuó huā	to blossom/see 著花|着花[zháo huā]
葵花	葵花	kuí huā	sunflower
葵花子	葵花子	kuí huā zǐ	sunflower seeds
蓮花	莲花	lián huā	lotus flower (Nelumbo nucifera Gaertn, among others)/water-lily
蓮花白	莲花白	lián huā bái	(dialect) cabbage
蓮花縣	莲花县	Lián huā xiàn	Lianhua county in Pingxiang 萍鄉|萍乡, Jiangxi
蓮花落	莲花落	lián huā lào	genre of folk song with accompaniment of bamboo clappers
蔥花	葱花	cōng huā	chopped onion
蕾絲花邊	蕾丝花边	lěi sī huā biān	lace border (loanword)
薔薇花蕾	蔷薇花蕾	qiáng wēi huā lěi	rosebud
藍枕花蜜鳥	蓝枕花蜜鸟	lán zhěn huā mì niǎo	(bird species of China) purple-naped sunbird (Hypogramma hypogrammicum)
藍飾帶花	蓝饰带花	lán shì dài huā	blue lace flower (Trachymene caerulea)
藏紅花	藏红花	zàng hóng huā	saffron (Crocus sativus)
蘆花黃雀	芦花黄雀	lú huā huáng què	oriental greenfinch (Carduelis sinica)
蘇花公路	苏花公路	Sū huā Gōng lù	Suhua Highway, coastal road in northern Taiwan, built on the side of cliffs above the Pacific Ocean
亂花	乱花	luàn huā	to spend recklessly/to waste money
蘭花	兰花	lán huā	cymbidium/orchid
蘭花指	兰花指	lán huā zhǐ	hand gesture in traditional dances (joined thumb and middle finger, the rest extended)
蛋花湯	蛋花汤	dàn huā tāng	clear soup containing beaten egg and green leafy vegetable/eggdrop soup
蝴蝶花	蝴蝶花	hú dié huā	iris/Iris tectorum
補花	补花	bǔ huā	applique
裱花袋	裱花袋	biǎo huā dài	pastry bag
西花廳	西花厅	Xī huā tīng	Xihuating pavilion on west side on Zhongnanhai, home to 周恩來|周恩来
西藍花	西蓝花	xī lán huā	variant of 西蘭花|西兰花[xī lán huā]
西蘭花	西兰花	xī lán huā	broccoli
警花	警花	jǐng huā	attractive policewoman/young female cop
豆花	豆花	dòu huā	jellied tofu/soft bean curd
貌美如花	貌美如花	mào měi rú huā	(of a woman) lovely as a flower (idiom)/beautiful
貼花	贴花	tiē huā	appliqué/decalcomania
走桃花運	走桃花运	zǒu táo huā yùn	to have luck with the ladies (idiom)
走馬看花	走马看花	zǒu mǎ kàn huā	lit. flower viewing from horseback (idiom); fig. superficial understanding from cursory observation/to make a quick judgment based on inadequate information
走馬觀花	走马观花	zǒu mǎ guān huā	lit. flower viewing from horseback (idiom); a fleeting glance in passing/fig. superficial understanding from cursory observation/to make a quick judgment based on inadequate information
踏青賞花	踏青赏花	tà qīng shǎng huā	to enjoy the flowers on a spring outing (idiom)
軋花機	轧花机	yà huā jī	cotton gin
迎春花	迎春花	yíng chūn huā	winter jasmine (Jasminum nudiflorum)
遍地開花	遍地开花	biàn dì kāi huā	to blossom everywhere/to spring up all over the place/to flourish on a large scale
達魯花赤	达鲁花赤	dá lǔ huā chì	Mongolian daruqachi, local commander in Mongol and Yuan times
郵花	邮花	yóu huā	(dialect) (postage) stamp
酒花	酒花	jiǔ huā	hops
酥油花	酥油花	sū yóu huā	butter sculpture (Tibetan art form using paint derived from milk products)
野花	野花	yě huā	wildflower/woman of easy virtue
野鼬瓣花	野鼬瓣花	yě yòu bàn huā	wild hemp
金針花	金针花	jīn zhēn huā	orange day-lily (Hemerocallis fulva)
金銀花	金银花	jīn yín huā	honeysuckle
金雀花	金雀花	jīn què huā	broom/furze (family Fabaceae)
鉤花	钩花	gōu huā	to crochet
銀蓮花	银莲花	yín lián huā	anemone
銅錘花臉	铜锤花脸	tóng chuí huā liǎn	(Chinese opera) tongchui hualian, a military character holding a bronze mace, classified as a jing 淨|净[jìng] role
鋼花	钢花	gāng huā	the fiery spray of molten steel
錦上添花	锦上添花	jǐn shàng tiān huā	lit. on brocade, add flowers (idiom); to decorate sth already perfect/gilding the lily
鏡花	镜花	jìng huā	decorative mirror
鏡花水月	镜花水月	jìng huā shuǐ yuè	lit. flowers in a mirror and the moon reflected in the lake (idiom)/fig. an unrealistic rosy view/viewing things through rose-tinted spectacles/also written 水月鏡花|水月镜花
鏡花緣	镜花缘	Jìng huā Yuán	Jinghua Yuan or Flowers in the Mirror, Qing novel of fantasy and erudition (early 19th century) by Li Ruzhen 李汝珍[Lǐ Rǔ zhēn]
鐵樹開花	铁树开花	tiě shù kāi huā	lit. the iron tree blooms (idiom)/a highly improbable or extremely rare occurrence
閉月羞花	闭月羞花	bì yuè xiū huā	lit. hiding the moon, shaming the flowers (idiom)/fig. female beauty exceeding even that of the natural world
開花	开花	kāi huā	to bloom/to blossom/to flower/fig. to burst open/to feel happy or elated/new development grows out
開花兒	开花儿	kāi huā r5	erhua variant of 開花|开花[kāi huā]
開花衣	开花衣	kāi huā yī	to open a bale of cotton
閑花	闲花	xián huā	wild flower
隱花植物	隐花植物	yǐn huā zhí wù	Cryptogamae/cryptogamous plant (botany)/plants such as algae 藻類|藻类[zǎo lèi], moss 苔蘚|苔藓[tái xiǎn] and fern 蕨類|蕨类[jué lèi] that reproduce by spores 孢子[bāo zǐ] in place of flowers
雕花	雕花	diāo huā	carving/decorative carved pattern/arabesque
雛菊花環	雏菊花环	chú jú huā huán	daisy chain/chain sinnet
雞冠花	鸡冠花	jī guān huā	cockscomb flower/Celosia cristata
雞米花	鸡米花	jī mǐ huā	chicken nuggets/popcorn chicken
雨花	雨花	Yǔ huā	Yuhua district of Changsha city 長沙市|长沙市[Cháng shā shì], Hunan
雨花區	雨花区	Yǔ huā qū	Yuhua district of Changsha city 長沙市|长沙市[Cháng shā shì], Hunan
雨花臺	雨花台	Yǔ huā tái	Yuhuatai district of Nanjing City 南京市 in Jiangsu 江蘇|江苏
雨花臺區	雨花台区	Yǔ huā tái qū	Yuhuatai district of Nanjing City 南京市 in Jiangsu 江蘇|江苏
雪花	雪花	xuě huā	snowflake
雪花膏	雪花膏	xuě huā gāo	vanishing cream/cold cream (makeup)
零花錢	零花钱	líng huā qián	pocket money/allowance
電火花	电火花	diàn huǒ huā	electric spark
霜花	霜花	shuāng huā	frost forming a pattern on a surface/rime
霧里看花	雾里看花	wù lǐ kàn huā	lit. to look at flowers in the fog (idiom); fig. blurred vision
青花	青花	qīng huā	blue and white (porcelain)
青花椰菜	青花椰菜	qīng huā yē cài	broccoli
青花瓷	青花瓷	qīng huā cí	blue and white porcelain
青花菜	青花菜	qīng huā cài	broccoli
靛花	靛花	diàn huā	indigo
韭菜花	韭菜花	jiǔ cài huā	chives (Allium tuberosum)
頭昏眼花	头昏眼花	tóu hūn yǎn huā	to faint with blurred vision (idiom); dizzy and eyes dimmed
頭暈眼花	头晕眼花	tóu yūn yǎn huā	to faint with blurred vision (idiom); dizzy and eyes dimmed
題花	题花	tí huā	title design
顯花植物	显花植物	xiǎn huā zhí wù	Phanerogamae (botany)/flowering plants
風花雪月	风花雪月	fēng huā xuě yuè	wind, flower, snow and moon, trite poetry subject (idiom); effete language without substance/love affair/romance is in the air/dissipated life
養花	养花	yǎng huā	growing flowers
香花	香花	xiāng huā	fragrant flower/fig. beneficial (of artworks etc)
馬纓花	马缨花	mǎ yīng huā	Persian silk tree (Albizia julibrissin)/tree rhododendron (Rhododendron delavayi)
馬蘭花	马兰花	mǎ lán huā	iris/Iris tectorum
魚花	鱼花	yú huā	fry/newly hatched fish
鮮花	鲜花	xiān huā	flower/fresh flowers/CL:朵[duǒ]
鮮花插在牛糞上	鲜花插在牛粪上	xiān huā chā zài niú fèn shàng	lit. a bunch of flowers poked into a pile of manure/fig. a terrible shame (as when a lovely woman marries an odious man)
鳥語花香	鸟语花香	niǎo yǔ huā xiāng	lit. birdsong and fragrant flowers (idiom); fig. the intoxication of a beautiful spring day
鳳仙花	凤仙花	fèng xiān huā	balsam/Balsaminaceae (a flower family including Impatiens balsamina)/touch-me-not/busy Lizzie
鳶尾花	鸢尾花	yuān wěi huā	iris (family Iridaceae)
麥迪遜廣場花園	麦迪逊广场花园	Mài dí xùn Guǎng chǎng Huā yuán	Madison Square Garden
麥迪遜花園廣場	麦迪逊花园广场	Mài dí xùn huā yuán guǎng chǎng	Madison Square Garden
麻花	麻花	má huā	fried dough twist (crisp snack food made by deep-frying plaited dough)/worn out or worn smooth (of clothes)
麻花辮	麻花辫	má huā biàn	braided pigtail
黃肛啄花鳥	黄肛啄花鸟	huáng gāng zhuó huā niǎo	(bird species of China) yellow-vented flowerpecker (Dicaeum chrysorrheum)
黃腹啄花鳥	黄腹啄花鸟	huáng fù zhuó huā niǎo	(bird species of China) yellow-bellied flowerpecker (Dicaeum melanoxanthum)
黃腹花蜜鳥	黄腹花蜜鸟	huáng fù huā mì niǎo	(bird species of China) olive-backed sunbird (Cinnyris jugularis)
黃花	黄花	huáng huā	yellow flowers (of various types)/chrysanthemum/cauliflower/(yellow) daylily/a young virgin (boy or girl)
黃花女	黄花女	huáng huā nǚ	maiden/virgin
黃花女兒	黄花女儿	huáng huā nǚ ér	see 黃花閨女|黄花闺女[huáng huā guī nǚ]
黃花姑娘	黄花姑娘	huáng huā gū niang	maiden/virgin girl
黃花崗	黄花岗	Huáng huā gǎng	Huanghuagang (Chrysanthemum Hill) in Guangzhou, scene of disastrous uprising of 23rd April 1911
黃花崗七十二烈士	黄花岗七十二烈士	Huáng huā gāng qī shí èr liè shì	the seventy two martyrs of the Huanghuagang uprising of 23rd April 1911
黃花崗起義	黄花岗起义	Huáng huā gǎng qǐ yì	Huanghuagang uprising of 23rd April 1911 in Guangzhou, one a long series of unsuccessful uprisings of Sun Yat-sen's revolutionary party
黃花幼女	黄花幼女	huáng huā yòu nǚ	maiden/virgin
黃花梨木	黄花梨木	huáng huā lí mù	yellow rosewood
黃花菜	黄花菜	huáng huā cài	citron daylily (Hemerocallis citrina Baroni)/golden needles (edible flower)
黃花菜都涼了	黄花菜都凉了	huáng huā cài dōu liáng le	lit. the dishes are cold (idiom)/fig. to arrive late/to take one's sweet time
黃花閨女	黄花闺女	huáng huā guī nǚ	maiden/virgin
黃花魚	黄花鱼	huáng huā yú	yellow croaker (fish)/corvina
黑漆麻花	黑漆麻花	hēi qī má huā	pitch-dark/coal black
龜殼花	龟壳花	guī ké huā	Formosan pit viper/Trimeresurus mucrosquamatus
