葡	葡	Pú	Portugal/Portuguese/abbr. for 葡萄牙[Pú táo yá]
葡	葡	pú	see 葡萄[pú tao]
樹葡萄	树葡萄	shù pú tao	jaboticaba/Brazilian grape tree
氨基葡糖	氨基葡糖	ān jī pú táng	glucosamine/abbr. for 氨基葡萄糖
氨基葡萄糖	氨基葡萄糖	ān jī pú tao táng	glucosamine (C6H13NO5)
吃不到葡萄說葡萄酸	吃不到葡萄说葡萄酸	chī bù dào pú tao shuō pú tao suān	sour grapes (set expr. based on Aesop)/lit. to say grapes are sour when you can't eat them
抗耐甲氧西林金葡菌	抗耐甲氧西林金葡菌	kàng nài jiǎ yǎng xī lín jīn pú jūn	methicillin-resistant Staphylococcus aureus (MRSA)
葡撻	葡挞	Pú tà	custard tart
葡糖	葡糖	pú táng	glucose C6H12O6/abbr. for 葡萄糖
葡糖胺	葡糖胺	pú táng àn	glucosamine/abbr. for 葡萄糖胺
葡萄	葡萄	pú tao	grape
葡萄乾	葡萄干	pú tao gān	raisin/dried grape
葡萄乾兒	葡萄干儿	pú tao gān r5	raisin
葡萄園	葡萄园	pú táo yuán	vineyard
葡萄彈	葡萄弹	pú tao dàn	grapeshot
葡萄柚	葡萄柚	pú táo yòu	grapefruit
葡萄汁	葡萄汁	pú táo zhī	grape juice
葡萄牙	葡萄牙	Pú táo yá	Portugal
葡萄牙人	葡萄牙人	Pú táo yá rén	Portuguese (person)
葡萄牙文	葡萄牙文	Pú táo yá wén	Portuguese (language)
葡萄牙語	葡萄牙语	Pú táo yá yǔ	Portuguese (language)
葡萄球菌	葡萄球菌	pú tao qiú jūn	staphylococcus
葡萄球菌腸毒素	葡萄球菌肠毒素	pú táo qiú jūn cháng dú sù	staphylococcal enterotoxin
葡萄糖	葡萄糖	pú tao táng	glucose C6H12O6
葡萄糖胺	葡萄糖胺	pú tao táng àn	glucosamine (C6H13NO5)/also written 氨基葡萄糖
葡萄紫	葡萄紫	pú tao zǐ	grayish purple color
葡萄胸鴨	葡萄胸鸭	pú táo xiōng yā	(bird species of China) American wigeon (Anas americana)
葡萄藤	葡萄藤	pú tao téng	grape vine
葡萄語	葡萄语	Pú táo yǔ	Portuguese (language)
葡萄酒	葡萄酒	pú tao jiǔ	(grape) wine
說葡萄酸	说葡萄酸	shuō pú tao suān	sour grapes (set expr. based on Aesop)/lit. to say grapes are sour when you can't eat them
酸葡萄	酸葡萄	suān pú tao	sour grapes
