浪	浪	làng	wave/breaker/unrestrained/dissipated/to stroll/to ramble
任憑風浪起，穩坐釣魚臺	任凭风浪起，稳坐钓鱼台	rèn píng fēng làng qǐ , wěn zuò diào yú tái	lit. sitting at ease in a fishing boat despite wind and storm (idiom); to stay calm during tense situation/a cool head in a crisis
古浪	古浪	Gǔ làng	Gulang county in Wuwei 武威[Wǔ wēi], Gansu
古浪縣	古浪县	Gǔ làng xiàn	Gulang county in Wuwei 武威[Wǔ wēi], Gansu
噗浪	噗浪	Pū làng	Plurk (Taiwanese social networking and microblogging service)
大浪	大浪	dà làng	billow/surge
孟浪	孟浪	mèng làng	hasty/rash/impetuous
惡浪	恶浪	è làng	violent wave/fierce billow/fig. depraved force
掀風鼓浪	掀风鼓浪	xiān fēng gǔ làng	to raise a storm/to stir up trouble/to instigate
揮霍浪費	挥霍浪费	huī huò làng fèi	to spend extravagantly/to squander
撥浪鼓	拨浪鼓	bō làng gǔ	a drum-shaped rattle (used by peddlers or as a toy)/rattle-drum
放浪	放浪	fàng làng	unrestrained/dissolute/dissipated/unconventional/immoral/to debauch/to dissipate
放浪不羈	放浪不羁	fàng làng bù jī	wanton and unrestrained (idiom); dissolute
放浪形骸	放浪形骸	fàng làng xíng hái	to abandon all restraint (idiom)
新浪	新浪	Xīn làng	Sina, Chinese web portal and online media company
新浪微博	新浪微博	Xīn làng Wēi bó	Sina Weibo, Chinese microblogging website
新浪網	新浪网	Xīn làng Wǎng	Sina, Chinese web portal and online media company
樂浪郡	乐浪郡	Lè làng jùn	Lelang commandery (108 BC-313 AD), one of four Han dynasty commanderies in north Korea
波浪	波浪	bō làng	wave
波浪號	波浪号	bō làng hào	tilde ( ~ )
津浪	津浪	jīn làng	tsunami/same as 海嘯|海啸
流浪	流浪	liú làng	to drift about/to wander/to roam/nomadic/homeless/unsettled (e.g. population)/vagrant
流浪兒	流浪儿	liú làng ér	street urchin/waif
流浪漢	流浪汉	liú làng hàn	tramp/wanderer
流浪狗	流浪狗	liú làng gǒu	stray dog
流浪者	流浪者	liú làng zhě	rover/vagabond/vagrant/wanderer
乘風破浪	乘风破浪	chéng fēng pò làng	to brave the wind and the billows (idiom); to have high ambitions
浪人	浪人	làng rén	vagrant/unemployed person/rōnin (wandering masterless samurai)
浪卡子	浪卡子	Làng kǎ zǐ	Nagarzê county, Tibetan: Sna dkar rtse rdzong, in Lhokha prefecture 山南地區|山南地区[Shān nán dì qū], Tibet
浪卡子縣	浪卡子县	Làng kǎ zǐ xiàn	Nagarzê county, Tibetan: Sna dkar rtse rdzong, in Lhokha prefecture 山南地區|山南地区[Shān nán dì qū], Tibet
浪女	浪女	làng nǚ	loose woman
浪子	浪子	làng zǐ	loafer/wastrel/prodigal son
浪子回頭	浪子回头	làng zǐ huí tóu	the return of a prodigal son (idiom)
浪子回頭金不換	浪子回头金不换	làng zǐ huí tóu jīn bù huàn	a prodigal son returned home is worth more than gold
浪得虛名	浪得虚名	làng dé xū míng	to have an undeserved reputation (idiom)
浪湧	浪涌	làng yǒng	(electrical) surge
浪漫	浪漫	làng màn	romantic
浪漫主義	浪漫主义	làng màn zhǔ yì	romanticism
浪潮	浪潮	làng cháo	wave/tides
浪濤	浪涛	làng tāo	ocean wave/billows
浪穀	浪谷	làng gǔ	trough of a wave/(fig.) low point/lowest level
浪船	浪船	làng chuán	swingboat
浪花	浪花	làng huā	spray/ocean spray/spindrift/fig. happenings from one's life/CL:朵[duǒ]
浪莽	浪莽	làng mǎng	vast
浪蕩	浪荡	làng dàng	to loiter/to hang around/dissolute/licentious
浪蝕	浪蚀	làng shí	wave erosion
浪費	浪费	làng fèi	to waste/to squander
浪費者	浪费者	làng fèi zhě	waster/wastrel/squanderer
浪費金錢	浪费金钱	làng fèi jīn qián	to squander money/to spend extravagantly
浪跡	浪迹	làng jì	to roam about/to wander without a home
浪跡天涯	浪迹天涯	làng jì tiān yá	to roam far and wide (idiom)/to travel the world
浪跡江湖	浪迹江湖	làng jì jiāng hú	to roam far and wide/to drift with the wind
浪頭	浪头	làng tou	wave
海浪	海浪	hǎi làng	sea wave
湧浪	涌浪	yǒng làng	swell/billows/surging waves
滄浪	沧浪	Cāng làng	Canglang district of Suzhou city 蘇州市|苏州市[Sū zhōu shì], Jiangsu
滄浪亭	沧浪亭	Cāng Làng tíng	The Surging Waves Pavillion in Suzhou, Jiangsu
滄浪區	沧浪区	Cāng làng qū	Canglang district of Suzhou city 蘇州市|苏州市[Sū zhōu shì], Jiangsu
激浪	激浪	Jī làng	Mountain Dew
無風三尺浪	无风三尺浪	wú fēng sān chǐ làng	lit. large waves in windless conditions (idiom)/fig. trouble arising unexpectedly
無風不起浪	无风不起浪	wú fēng bù qǐ làng	lit. without wind there cannot be waves (idiom); there must be a reason/no smoke without fire
熱浪	热浪	rè làng	heat wave
破浪	破浪	pò làng	to set sail/to brave the waves
聲浪	声浪	shēng làng	clamor
興風作浪	兴风作浪	xīng fēng zuò làng	to incite trouble/to stir up havoc
莊浪	庄浪	Zhuāng làng	Zhuanglang county in Pingliang 平涼|平凉[Píng liáng], Gansu
莊浪縣	庄浪县	Zhuāng làng xiàn	Zhuanglang county in Pingliang 平涼|平凉[Píng liáng], Gansu
衝浪	冲浪	chōng làng	to surf/surfing
衝浪板	冲浪板	chōng làng bǎn	surfboard/paddleboard
衝浪者	冲浪者	chōng làng zhě	surfer
趕浪頭	赶浪头	gǎn làng tou	to follow the trend
輕浪浮薄	轻浪浮薄	qīng làng fú bó	(idiom) frivolous
鋪張浪費	铺张浪费	pū zhāng làng fèi	extravagance and waste (idiom)
長江後浪催前浪	长江后浪催前浪	Cháng Jiāng hòu làng cuī qián làng	see 長江後浪推前浪|长江后浪推前浪[Cháng Jiāng hòu làng tuī qián làng]
長江後浪推前浪	长江后浪推前浪	Cháng Jiāng hòu làng tuī qián làng	lit. the rear waves of the Yangtze River drive on those before (idiom)/fig. the new is constantly replacing the old/each new generation excels the previous/(of things) to be constantly evolving
長風破浪	长风破浪	cháng fēng pò làng	lit. to ride the wind and crest the waves/to be ambitious and unafraid (idiom)
風口浪尖	风口浪尖	fēng kǒu làng jiān	where the wind and the waves are the fiercest/at the heart of the struggle
風平浪靜	风平浪静	fēng píng làng jìng	lit. breeze is still, waves are quiet (idiom); tranquil environment/all is quiet/a dead calm (at sea)
風恬浪靜	风恬浪静	fēng tián làng jìng	lit. breeze is still, waves are quiet (idiom); tranquil environment/All is quiet./a dead calm (at sea)
風浪	风浪	fēng làng	wind and waves/stormy sea
風浪板	风浪板	fēng làng bǎn	(Tw) windsurfing/sailboard
風箏衝浪	风筝冲浪	fēng zhēng chōng làng	kitesurfing
駭浪	骇浪	hài làng	swelling or stormy seas
驚濤駭浪	惊涛骇浪	jīng tāo hài làng	perilous situation
鼓浪嶼	鼓浪屿	Gǔ làng yǔ	Gulangyu, scenic island off Xiamen 廈門|厦门[Xià mén]
