具	具	jù	tool/device/utensil/equipment/instrument/talent/ability/to possess/to have/to provide/to furnish/to state/classifier for devices, coffins, dead bodies
假面具	假面具	jiǎ miàn jù	mask/fig. false façade/deceptive front
傢具	傢具	jiā jù	variant of 家具[jiā jù]
交通工具	交通工具	jiāo tōng gōng jù	means of transportation/vehicle
具保	具保	jù bǎo	to find guarantor/to find surety
具備	具备	jù bèi	to possess/to have/equipped with/able to fulfill (conditions or requirements)
具名	具名	jù míng	to sign/to put one's name to
具有	具有	jù yǒu	to have/to possess
具有主權	具有主权	jù yǒu zhǔ quán	sovereign
具格	具格	jù gé	instrumental case (grammar)
具爾	具尔	jù ěr	brother
具結	具结	jù jié	to bind over (as surety)/to sign an undertaking
具象	具象	jù xiàng	tangible image/concrete/representational (art)
具體	具体	jù tǐ	concrete/definite/specific
具體到	具体到	jù tǐ dào	to embody into/to apply to/to take the shape of/specific to
具體化	具体化	jù tǐ huà	to concretize
具體問題	具体问题	jù tǐ wèn tí	concrete issue
具體而微	具体而微	jù tǐ ér wēi	miniature/scaled-down/forming a microcosm
具體計劃	具体计划	jù tǐ jì huà	a concrete plan/a definite plan
具體說明	具体说明	jù tǐ shuō míng	explicit explanation/to specify
兼具	兼具	jiān jù	to combine/to have both
出具	出具	chū jù	to issue (document, certificate etc)/to provide
刀具	刀具	dāo jù	cutting tool
刃具	刃具	rèn jù	cutting tool
刑具	刑具	xíng jù	punishment equipment/torture instrument
別具	别具	bié jù	see 獨具|独具[dú jù]
別具一格	别具一格	bié jù yī gé	having a unique or distinctive style
別具隻眼	别具只眼	bié jù zhī yǎn	see 獨具隻眼|独具只眼[dú jù zhī yǎn]
吊具	吊具	diào jù	spreader (for pallet, container etc)
器具	器具	qì jù	implement/ware
大道具	大道具	dà dào jù	(theater) set prop (desk, chairs etc)
夯具	夯具	hāng jù	rammer/tamper
夾具	夹具	jiā jù	clamp/fixture (machining)
家具	家具	jiā jù	furniture/CL:件[jiàn],套[tào]
寢具	寝具	qǐn jù	bedding
小道具	小道具	xiǎo dào jù	(theater) hand prop (wine glass, pistol etc)
工具	工具	gōng jù	tool/instrument/utensil/means (to achieve a goal etc)
工具書	工具书	gōng jù shū	reference book (such as dictionary, almanac, gazetteer etc)
工具條	工具条	gōng jù tiáo	toolbar (in computer software)
工具機	工具机	gōng jù jī	machine tool
工具欄	工具栏	gōng jù lán	toolbar (in computer software)
工具箱	工具箱	gōng jù xiāng	toolbox
廁具	厕具	cè jù	toilet fittings
廚具	厨具	chú jù	kitchen implements
徒具	徒具	tú jù	to only have
拼圖玩具	拼图玩具	pīn tú wán jù	jigsaw puzzle
拼板玩具	拼板玩具	pīn bǎn wán jù	jigsaw puzzle/wood block puzzle
挽具	挽具	wǎn jù	harness
擬具	拟具	nǐ jù	to draft/to devise/to compose
教具	教具	jiào jù	teaching aids/educational materials
文具	文具	wén jù	stationery/item of stationery (pen, pencil, eraser, pencil sharpener etc)
文具商	文具商	wén jù shāng	stationer
文具店	文具店	wén jù diàn	stationery store
智力玩具	智力玩具	zhì lì wán jù	educational toy
杯具	杯具	bēi jù	cup/(slang) (pun on 悲劇|悲剧[bēi jù], tragedy) so bad/terrible/bummer/fiasco/debacle
棋具	棋具	qí jù	checkers (board and pieces for go 圍棋|围棋 or Chinese chess 象棋 etc)
模具	模具	mú jù	mold/matrix/pattern or die/Taiwan pr. [mó jù]
毛絨玩具	毛绒玩具	máo róng wán jù	plush toy/cuddly toy
洩慾工具	泄欲工具	xiè yù gōng jù	sexual object
浮潛器具	浮潜器具	fú qián qì jù	diving equipment
測量工具	测量工具	cè liáng gōng jù	gauge/measuring tool
漁具	渔具	yú jù	fishing gear
潔具	洁具	jié jù	bathroom fittings (washbasin, bathtub, toilet etc)
灶具	灶具	zào jù	stove/cooker/(dialect) cooking utensils
炊具	炊具	chuī jù	cooking utensils/cookware/cooker
獨具	独具	dú jù	to have unique (talent, insight etc)
獨具匠心	独具匠心	dú jù jiàng xīn	original and ingenious (idiom)/to show great creativity
獨具隻眼	独具只眼	dú jù zhī yǎn	to see what others fail to see (idiom)/to have exceptional insight
玩具	玩具	wán jù	plaything/toy
玩具廠	玩具厂	wán jù chǎng	toy factory
玩具槍	玩具枪	wán jù qiāng	toy gun
用具	用具	yòng jù	appliance/utensil/gear/equipment
百廢具興	百废具兴	bǎi fèi jù xīng	variant of 百廢俱興|百废俱兴[bǎi fèi jù xīng]
皮具	皮具	pí jù	leather products/CL:件[jiàn]
益智玩具	益智玩具	yì zhì wán jù	educational toy
瞄準具	瞄准具	miáo zhǔn jù	sighting device/sight (for a firearm etc)
索具裝置	索具装置	suǒ jù zhuāng zhì	rig
臥具	卧具	wò jù	bedding
茶具	茶具	chá jù	tea set/tea service
衍生工具	衍生工具	yǎn shēng gōng jù	derivative (finance)
裝飾道具	装饰道具	zhuāng shì dào jù	(theater) set dressing/trim prop
載具	载具	zài jù	conveyance (car, boat, aircraft etc)/vehicle/(fig.) medium/platform/vector
輔具	辅具	fǔ jù	assistive device (walking frame, hearing aid etc)
農具	农具	nóng jù	farm implements/farm tools
道具	道具	dào jù	prop (theater)/paraphernalia/(gaming) item/artifact
道具服	道具服	dào jù fú	costume
酒具	酒具	jiǔ jù	wine vessel/wine cup
量具	量具	liáng jù	measuring device
釣具	钓具	diào jù	fishing tackle
開具	开具	kāi jù	to draw up (a document)
防毒面具	防毒面具	fáng dú miàn jù	gas mask
陽具	阳具	yáng jù	penis
隨身道具	随身道具	suí shēn dào jù	(theater) personal prop (spectacles, fan etc)
隻眼獨具	只眼独具	zhī yǎn dú jù	see 獨具隻眼|独具只眼[dú jù zhī yǎn]
雨具	雨具	yǔ jù	rainwear
電動玩具	电动玩具	diàn dòng wán jù	battery-powered toy/(Tw) video game/computer game
面具	面具	miàn jù	mask
頗具	颇具	pō jù	rather/quite/to have much
食具	食具	shí jù	tableware
餐具	餐具	cān jù	tableware/dinner service
馬具	马具	mǎ jù	harness
魚具	鱼具	yú jù	variant of 漁具|渔具[yú jù]
鵰具座	雕具座	Diāo jù zuò	Caelum (constellation)
