單	单	Shàn	surname Shan
單	单	dān	bill/list/form/single/only/sole/odd number/CL:個|个[gè]
下訂單	下订单	xià dìng dān	to place an order (commerce)
不單	不单	bù dān	not the only/not merely/not simply
不簡單	不简单	bù jiǎn dān	not simple/rather complicated/remarkable/marvelous
亞單位	亚单位	yà dān wèi	subunit
亞音節單位	亚音节单位	yà yīn jié dān wèi	subsyllabic unit
交款單	交款单	jiāo kuǎn dān	payment slip
保單	保单	bǎo dān	guarantee slip
保險單	保险单	bǎo xiǎn dān	insurance policy (document)
候補名單	候补名单	hòu bǔ míng dān	waiting list
借單	借单	jiè dān	receipt for a loan/written confirmation of a debt/IOU
借單兒	借单儿	jiè dān r5	receipt for a loan/written confirmation of a debt/IOU
借書單	借书单	jiè shū dān	book slip
停損單	停损单	tíng sǔn dān	stop order (finance)
傳單	传单	chuán dān	leaflet/flier/pamphlet
傳單廣	传单广	chuán dān guǎng	advertising leaflet/circular
全國重點文物保護單位	全国重点文物保护单位	Quán guó Zhòng diǎn Wén wù Bǎo hù Dān wèi	Major Historical and Cultural Site Protected at the National Level
公制單位	公制单位	gōng zhì dān wèi	metric units
刷單	刷单	shuā dān	to generate fake transactions in order to game a commercial online platform (one that rewards users who make numerous transactions)
名單	名单	míng dān	list of names
上下文菜單	上下文菜单	shàng xià wén cài dān	context menu (computing)
下單	下单	xià dān	to place an order/to order/an order (of goods)
單一	单一	dān yī	single/only/sole
單一合體字	单一合体字	dān yī hé tǐ zì	unique compound
單一碼	单一码	dān yī mǎ	Unicode/also written 統一碼|统一码
單一貨幣	单一货币	dān yī huò bì	single currency
單于	单于	chán yú	chanyu (Han Dynasty name for chiefs of Xiongnu Huns 匈奴[Xiōng nú])
單人	单人	dān rén	one person/single (room, bed etc)
單人匹馬	单人匹马	dān rén pǐ mǎ	single-handedly (idiom)
單人床	单人床	dān rén chuáng	single bed/CL:張|张[zhāng]
單人沙發	单人沙发	dān rén shā fā	(upholstered) armchair
單人間	单人间	dān rén jiān	single room (hotel)
單位	单位	dān wèi	unit (of measure)/unit (group of people as a whole)/work unit (place of employment, esp. in the PRC prior to economic reform)/CL:個|个[gè]
單位信托	单位信托	dān wèi xìn tuō	unit trust (finance)
單位元	单位元	dān wèi yuán	identity element (math.)
單位切向量	单位切向量	dān wèi qiē xiàng liàng	unit tangent vector (math.)
單位向量	单位向量	dān wèi xiàng liàng	unit vector (math.)
單位根	单位根	dān wèi gēn	(math.) root of unity
單位犯罪	单位犯罪	dān wèi fàn zuì	crime committed by an organization
單個	单个	dān ge	single/alone/individually/an odd one
單個兒	单个儿	dān gè r5	erhua variant of 單個|单个[dān ge]
單倍體	单倍体	dān bèi tǐ	haploid (single chromosome)
單側	单侧	dān cè	one-sided/unilateral
單傳	单传	dān chuán	to have only one heir in a generation (of a family, clan etc)/to be learned from only one master (of a skill, art etc)
單價	单价	dān jià	unit price
單元	单元	dān yuán	unit (forming an entity)/element/(in a residential building) entrance or staircase
單元房	单元房	dān yuán fáng	apartment
單元格	单元格	dān yuán gé	(spreadsheet) cell
單克隆抗體	单克隆抗体	dān kè lóng kàng tǐ	monoclonal antibody
單兵	单兵	dān bīng	individual soldier/(literary) isolated military unit, cut off from reinforcements
單刀直入	单刀直入	dān dāo zhí rù	to get straight to the point (idiom)
單刀赴會	单刀赴会	dān dāo fù huì	lit. to go among enemies with only one's sword (idiom)/fig. to go alone into enemy lines
單反機	单反机	dān fǎn jī	see 單反相機|单反相机[dān fǎn xiàng jī]
單反相機	单反相机	dān fǎn xiàng jī	single-lens reflex camera (SLR)
單叢	单丛	Dān cōng	a class of oolong tea
單口相聲	单口相声	dān kǒu xiàng shēng	comic monologue/one-person comic sketch
單句	单句	dān jù	simple sentence (grammar)
單另	单另	dān lìng	separately and exclusively/specially
單向	单向	dān xiàng	unidirectional
單向電流	单向电流	dān xiàng diàn liú	(elec.) unidirectional current/DC/also written 直流[zhí liú]
單味藥	单味药	dān wèi yào	medicine made from a single herb/drug made from a single substance
單單	单单	dān dān	only/merely/just
單團	单团	dān tuán	ad hoc group (tour group with a customized itinerary)
單套	单套	dān tào	single set
單子	单子	dān zǐ	the only son of a family/(functional programming or philosophy) monad
單子	单子	dān zi	list of items/bill/form/bedsheet
單子葉	单子叶	dān zǐ yè	monocotyledon (plant family distinguished by single embryonic leaf, includes grasses, orchids and lilies)
單字	单字	dān zì	single Chinese character/word (in a foreign language)
單寧酸	单宁酸	dān níng suān	tannic acid (loanword)
單射	单射	dān shè	one-to-one function/injective map (math.)
單層	单层	dān céng	single layer/single story/single deck/single level
單層塔	单层塔	dān céng tǎ	single-storied pagoda
單峰駝	单峰驼	dān fēng tuó	dromedary
單幹	单干	dān gàn	to work on one's own/to work single-handed/individual farming
單張	单张	dān zhāng	flyer/leaflet/single-sheet (map etc)
單張匯票	单张汇票	dān zhāng huì piào	sola bill of exchange (international trade)
單意	单意	dān yì	unambiguous/having only one meaning
單戀	单恋	dān liàn	unrequited love/one-sided love
單房差	单房差	dān fáng chā	single supplement (for a hotel room)
單手	单手	dān shǒu	one hand/single-handed
單打	单打	dān dǎ	singles (in sports)/CL:場|场[chǎng]
單打獨鬥	单打独斗	dān dǎ dú dòu	to fight alone (idiom)
單挑	单挑	dān tiāo	to pick/to choose/to fight a duel
單擊	单击	dān jī	to click (using a mouse or other pointing device)
單據	单据	dān jù	receipts/invoices/transaction records
單擺	单摆	dān bǎi	simple pendulum (physics)
單放機	单放机	dān fàng jī	tape player/video player/(media) player/play-only device
單數	单数	dān shù	positive odd number (also written 奇數|奇数)/singular (grammar)
單方	单方	dān fāng	unilateral/one-sided/home remedy/folk prescription(same as 丹方)/single-drug prescription (same as 奇方[jī fāng], one of the seven kinds of prescriptions of Chinese medicine 七方[qī fāng])/metaphorically. a good solution
單方向	单方向	dān fāng xiàng	unidirectional/single-aspect
單方宣告	单方宣告	dān fāng xuān gào	unilateral declaration
單方恐嚇	单方恐吓	dān fāng kǒng hè	unilateral threat
單方決定	单方决定	dān fāng jué dìng	to decide without reference to other parties involved/unilateral decision
單方製劑	单方制剂	dān fāng zhì jì	prescribed preparation
單方過失碰撞	单方过失碰撞	dān fāng guò shī pèng zhuàng	collision in which only one party is at fault
單方面	单方面	dān fāng miàn	unilateral
單日	单日	dān rì	on a single day
單晶	单晶	dān jīng	monocrystalline
單曲	单曲	dān qǔ	single (recording industry)
單月	单月	dān yuè	monthly/in a single month
單板機	单板机	dān bǎn jī	single-board computer
單板滑雪	单板滑雪	dān bǎn huá xuě	to snowboard
單核細胞	单核细胞	dān hé xì bāo	monocyte/mononuclear cell
單核細胞增多症	单核细胞增多症	dān hé xì bāo zēng duō zhèng	mononucleosis
單根獨苗	单根独苗	dān gēn dú miáo	an only child
單極	单极	dān jí	unipolar/monopole (physics)
單槍匹馬	单枪匹马	dān qiāng pǐ mǎ	lit. single spear and horse (idiom); fig. single-handed/unaccompanied
單槓	单杠	dān gàng	bar/bold line/horizontal bar (gymnastics event)
單樅	单枞	Dān cōng	variant of 單叢|单丛[Dān cōng]
單模	单模	dān mó	single mode
單模光纖	单模光纤	dān mó guāng xiān	single mode fiber
單源多倍體	单源多倍体	dān yuán duō bèi tǐ	autopolyploid (polyploid with chromosomes of single species)
單源論	单源论	dān yuán lùn	theory of single origin (of mankind)
單片機	单片机	dān piàn jī	microcontroller/one-chip computer
單獨	单独	dān dú	alone/by oneself/on one's own
單班課	单班课	dān bān kè	individual lesson/one-on-one class
單瓣	单瓣	dān bàn	single petal/single valve
單產	单产	dān chǎn	yield per unit area
單用	单用	dān yòng	to use (sth) on its own
單盲	单盲	dān máng	single-blind (scientific experiment)
單相	单相	dān xiàng	single phase (elec.)
單相思	单相思	dān xiāng sī	one-sided lovesickness/unrequited longing
單眼	单眼	dān yǎn	ommatidium (single component of insect's compound eye)/one eye (i.e. one's left or right eye)
單眼皮	单眼皮	dān yǎn pí	single eyelid
單眼相機	单眼相机	dān yǎn xiàng jī	single-lens reflex camera (Tw)
單程	单程	dān chéng	one-way (ticket)
單穩	单稳	dān wěn	monostable/single-side stable (relays)
單端孢霉烯類毒素	单端孢霉烯类毒素	dān duān bāo méi xī lèi dú sù	trichothecenes (TS, T-2)
單端孢霉烯類毒素中毒症	单端孢霉烯类毒素中毒症	dān duān bāo méi xī lèi dú sù zhōng dú zhèng	trichothecenes toxicosis
單簧管	单簧管	dān huáng guǎn	clarinet
單糖	单糖	dān táng	monosaccharide
單純	单纯	dān chún	simple/pure/unsophisticated/merely/purely
單純皰疹	单纯疱疹	dān chún pào zhěn	herpes simplex (med.)
單純皰疹病毒	单纯疱疹病毒	dān chún pào zhěn bìng dú	herpes simplex virus (HSV, med.)
單純詞	单纯词	dān chún cí	(linguistics) single-morpheme word/simple word
單細胞	单细胞	dān xì bāo	single-celled (organism)/unicellular
單細胞生物	单细胞生物	dān xì bāo shēng wù	single-celled organism
單絲不成線，獨木不成林	单丝不成线，独木不成林	dān sī bù chéng xiàn , dú mù bù chéng lín	one strand does not make a thread, one tree does not make a forest (idiom)
單縣	单县	Shàn xiàn	Shan county in Heze 菏澤|菏泽[Hé zé], Shandong
單翼飛機	单翼飞机	dān yì fēi jī	monoplane
單肩包	单肩包	dān jiān bāo	shoulder bag
單胞藻	单胞藻	dān bāo zǎo	single-celled algae
單腳跳	单脚跳	dān jiǎo tiào	to hop/to jump on one leg
單色	单色	dān sè	monochrome/monochromatic/black and white
單色照片	单色照片	dān sè zhào piàn	monochrome photo/black and white picture
單色畫	单色画	dān sè huà	monochrome picture/black and white picture
單葉雙曲面	单叶双曲面	dān yè shuāng qū miàn	hyperboloid of one sheet (math.)
單薄	单薄	dān bó	weak/frail/thin/flimsy
單號	单号	dān hào	odd number (on a ticket, house etc)
單行	单行	dān xíng	to come individually/to treat separately/separate edition/one-way traffic
單行本	单行本	dān xíng běn	single volume edition/offprint
單行線	单行线	dān xíng xiàn	one-way road
單行道	单行道	dān xíng dào	one-way street
單衣	单衣	dān yī	unlined garment
單褲	单裤	dān kù	unlined trousers/summer trousers
單親	单亲	dān qīn	single parent
單親家庭	单亲家庭	dān qīn jiā tíng	single parent family
單詞	单词	dān cí	word/CL:個|个[gè]
單詞產生器模型	单词产生器模型	dān cí chǎn shēng qì mó xíng	logogen model
單語	单语	dān yǔ	monolingual
單調	单调	dān diào	monotonous
單調乏味	单调乏味	dān diào fá wèi	monotonous/dull/tedious (idiom)
單證	单证	dān zhèng	(international trade) documentation (e.g. a bill of lading)
單質	单质	dān zhì	simple substance (consisting purely of one element, such as diamond)
單趟	单趟	dān tàng	single trip
單身	单身	dān shēn	unmarried/single
單身汪	单身汪	dān shēn wāng	(Internet slang) person who is neither married nor in a relationship (used self-deprecatingly)
單身漢	单身汉	dān shēn hàn	bachelor/unmarried man
單身狗	单身狗	dān shēn gǒu	(Internet slang) person who is neither married nor in a relationship (used self-deprecatingly)
單身貴族	单身贵族	dān shēn guì zú	fig. unmarried person/single person (especially one who is comfortable financially)
單車	单车	dān chē	(coll.) bike/bicycle (esp. bike-share bicycle)
單車族	单车族	dān chē zú	cyclist
單軌	单轨	dān guǐ	monorail
單輪車	单轮车	dān lún chē	unicycle
單速車	单速车	dān sù chē	single-speed bicycle/fixed-gear bicycle
單連接站	单连接站	dān lián jiē zhàn	single attachment station (telecommunications)
單過	单过	dān guò	to live independently/to live on one's own
單邊	单边	dān biān	unilateral
單邊主義	单边主义	dān biān zhǔ yì	unilateralism
單鉻	单铬	dān gè	monochrome
單鍵	单键	dān jiàn	single bond (chemistry)
單鏈	单链	dān liàn	single chain/refers to RNA as opposed to the double helix DNA
單鏡反光相機	单镜反光相机	dān jìng fǎn guāng xiàng jī	single-lens reflex camera (SLR)
單間差	单间差	dān jiān chā	single supplement (for a hotel room)
單院制	单院制	dān yuàn zhì	unicameralism/single-house system
單非	单非	dān fēi	a couple in which one of the spouses is not a Hong Kong citizen
單鞋	单鞋	dān xié	unpadded shoes
單音節	单音节	dān yīn jié	monosyllabic/a monosyllable
單音詞	单音词	dān yīn cí	monosyllabic word
單韻母	单韵母	dān yùn mǔ	simple finals
單項	单项	dān xiàng	single-item
單體	单体	dān tǐ	monomer
單點	单点	dān diǎn	to order à la carte/single point (of measurement, mounting etc)
回單	回单	huí dān	receipt
回單兒	回单儿	huí dān r5	erhua variant of 回單|回单[huí dān]
回執單	回执单	huí zhí dān	receipt
國際單位	国际单位	guó jì dān wèi	international unit
國際單位制	国际单位制	guó jì dān wèi zhì	International System of Units
地積單	地积单	dì jī dān	unit of area (e.g. 畝|亩[mǔ], Chinese acre)
埋單	埋单	mái dān	to pay the bill (in a restaurant etc) (loanword from Cantonese)/(fig.) to bear responsibility
基本單位	基本单位	jī běn dān wèi	basic unit/fundamental building block
報價單	报价单	bào jià dān	quotation/price list/written estimate of price
報單	报单	bào dān	a tax declaration form/a tax return
報稅單	报税单	bào shuì dān	to declare to customs or to the taxman
天文單位	天文单位	tiān wén dān wèi	astronomical unit (AU)
失單	失单	shī dān	list of lost or stolen articles
女單	女单	nǚ dān	women's singles (in tennis, badminton etc)
孑影孤單	孑影孤单	jié yǐng gū dān	to be all alone by oneself
存款單	存款单	cún kuǎn dān	certificate of deposit
孤單	孤单	gū dān	lone/lonely/loneliness
定單	定单	dìng dān	variant of 訂單|订单[dìng dān]
工作單位	工作单位	gōng zuò dān wèi	work unit
帳單	帐单	zhàng dān	bill/check
床單	床单	chuáng dān	bed sheet/CL:條|条[tiáo],件[jiàn],張|张[zhāng],床[chuáng]
形單影隻	形单影只	xíng dān yǐng zhī	lonely soul/solitary
心願單	心愿单	xīn yuàn dān	wish list
憑單	凭单	píng dān	bill of warrant (certificate, allowing one to collect money or valuables)
成績單	成绩单	chéng jì dān	school report or transcript
所屬單位	所属单位	suǒ shǔ dān wèi	affiliated unit/subsidiary
接單	接单	jiē dān	to take a customer's order/(of a taxi driver) to accept a booking/(of a delivery rider) to accept a delivery job
提單	提单	tí dān	bill of lading
提貨單	提货单	tí huò dān	bill of lading
換單	换单	huàn dān	bill of exchange (international trade)
摩拜單車	摩拜单车	Mó bài Dān chē	Mobike, operator of an app-driven bicycle-rental business in China, established in 2015
施工單位	施工单位	shī gōng dān wèi	unit in charge of construction/builder
有限單元	有限单元	yǒu xiàn dān yuán	finite element (method)
棧單	栈单	zhàn dān	cargo receipt/landing account/warehouse or storage receipt/CL:張|张[zhāng]
模塊單元	模块单元	mó kuài dān yuán	modular unit
樣單	样单	yàng dān	sample sheet/form/stylesheet (computing)
氯單質	氯单质	lǜ dān zhì	molecular chlorine
水上電單車	水上电单车	shuǐ shàng diàn dān chē	see 水上摩托車|水上摩托车[shuǐ shàng mó tuō chē]
決選名單	决选名单	jué xuǎn míng dān	short list
清單	清单	qīng dān	list of items
溴單質	溴单质	xiù dān zhì	molecular bromine
滾床單	滚床单	gǔn chuáng dān	(coll.) to have sex
照單全收	照单全收	zhào dān quán shōu	to accept without question/to take sth at face value
熱量單位	热量单位	rè liàng dān wèi	thermal unit/unit of heat
生產單位	生产单位	shēng chǎn dān wèi	production unit
申報單	申报单	shēn bào dān	declaration form
男單	男单	nán dān	men's singles (in tennis, badminton etc)
男子單	男子单	nán zǐ dān	men's singles (sports)
白名單	白名单	bái míng dān	whitelist
磁單極子	磁单极子	cí dān jí zǐ	magnetic monopole
禍不單行	祸不单行	huò bù dān xíng	misfortune does not come singly (idiom)/it never rains but it pours
簡單	简单	jiǎn dān	simple/not complicated
簡單化	简单化	jiǎn dān huà	simplification/to simplify
簡單地說	简单地说	jiǎn dān de shuō	to put it simply/simply put
簡單明瞭	简单明了	jiǎn dān míng liǎo	clear and simple/in simple terms
簡單網絡管理協議	简单网络管理协议	jiǎn dān wǎng luò guǎn lǐ xié yì	Simple Network Management Protocol/SNMP
結單	结单	jié dān	statement of account
總運單	总运单	zǒng yùn dān	master air waybill (MAWB) (transport)
罰單	罚单	fá dān	violation ticket/infringement notice
肽單位	肽单位	tài dān wèi	peptide unit (on protein chain)
脫單	脱单	tuō dān	to find oneself a partner
航空運單	航空运单	háng kōng yùn dān	Air Waybill (AWB)
菜單	菜单	cài dān	menu/CL:份[fèn],張|张[zhāng]
菜單條	菜单条	cài dān tiáo	menu bar (of a computer application)
菜單欄	菜单栏	cài dān lán	menu bar (computing)
落單	落单	luò dān	to be on one's own/to be left alone/to be left out
行政單位	行政单位	xíng zhèng dān wèi	administrative unit (e.g. province 省[shěng], prefecture 地區|地区[dì qū] or county 縣|县[xiàn])
行程單	行程单	xíng chéng dān	(e-ticket) itinerary receipt
衣單食薄	衣单食薄	yī dān shí bó	thin coat, meager food (idiom); life of wretched poverty/destitute
表單	表单	biǎo dān	form (document)
被單	被单	bèi dān	(bed) sheet/envelope for a padded coverlet/CL:床[chuáng]
西單	西单	Xī dān	Xidan neighborhood of central Beijing
觸發清單	触发清单	chù fā qīng dān	trigger list
訂單	订单	dìng dān	(purchase) order
訂單號	订单号	dìng dān hào	order number
買單	买单	mǎi dān	to pay the restaurant bill
費用報銷單	费用报销单	fèi yòng bào xiāo dān	expense claim form
賬單	账单	zhàng dān	bill
通知單	通知单	tōng zhī dān	notification/notice/ticket/receipt
運單	运单	yùn dān	way bill/transport charge
過份簡單化	过份简单化	guò fèn jiǎn dān huà	oversimplification/to oversimplify
選單	选单	xuǎn dān	(software) menu
酒單	酒单	jiǔ dān	wine list (in a restaurant etc)
重量單位	重量单位	zhòng liàng dān wèi	unit of weight
銀行對賬單	银行对账单	yín háng duì zhàng dān	bank statement
長度單位	长度单位	cháng dù dān wèi	unit of length
開單	开单	kāi dān	to bill/to open a tab
開罰單	开罚单	kāi fá dān	to issue an infringement notice
非洲單源說	非洲单源说	Fēi zhōu dān yuán shuō	single origin out of Africa (current mainstream theory of human evolution)
領料單	领料单	lǐng liào dān	material requisition form
頭腦簡單四肢發達	头脑简单四肢发达	tóu nǎo jiǎn dān sì zhī fā dá	all brawn no brains
類鼻疽單細胞	类鼻疽单细胞	lèi bí jū dān xì bāo	Pseudomonas pseudomallei
體積單位	体积单位	tǐ jī dān wèi	unit of volume
黑名單	黑名单	hēi míng dān	blacklist
