寧	宁	Níng	abbr. for Ningxia Hui Autonomous Region 寧夏回族自治區|宁夏回族自治区[Níng xià Huí zú Zì zhì qū]/abbr. for Nanjing 南京[Nán jīng]/surname Ning
寧	宁	níng	peaceful/to pacify/to visit (one's parents etc)
寧	宁	nìng	would rather/to prefer/how (emphatic)/Taiwan pr. [níng]
中寧縣	中宁县	Zhōng níng xiàn	Zhongning county in Zhongwei 中衛|中卫[Zhōng wèi], Ningxia
丹寧	丹宁	dān níng	(loanword) denim/tannin
亞平寧	亚平宁	Yà píng nìng	Apennine (Mountains)
伊寧	伊宁	Yī níng	Yining city and county or Ghulja nahiyisi in Ili Kazakh autonomous prefecture 伊犁哈薩克自治州|伊犁哈萨克自治州[Yī lí Hā sà kè zì zhì zhōu], Xinjiang
伊寧市	伊宁市	Yī níng shì	Gulja or Yining city in Xinjiang, capital of Ili Kazakh autonomous prefecture
伊寧縣	伊宁县	Yī níng xiàn	Yining county or Ghulja nahiyisi in Ili Kazakh autonomous prefecture 伊犁哈薩克自治州|伊犁哈萨克自治州[Yī lí Hā sà kè zì zhì zhōu], Xinjiang
休寧	休宁	Xiū níng	Xiuning county in Huangshan 黃山|黄山[Huáng shān], Anhui
休寧縣	休宁县	Xiū níng xiàn	Xiuning county in Huangshan 黃山|黄山[Huáng shān], Anhui
冕寧	冕宁	Miǎn níng	Mianning county in Liangshan Yi autonomous prefecture 涼山彞族自治州|凉山彝族自治州[Liáng shān Yí zú zì zhì zhōu], south Sichuan
冕寧縣	冕宁县	Miǎn níng xiàn	Mianning county in Liangshan Yi autonomous prefecture 涼山彞族自治州|凉山彝族自治州[Liáng shān Yí zú zì zhì zhōu], south Sichuan
列寧	列宁	Liè níng	Vladimir Ilyich Lenin (1870-1924), Russian revolutionary leader
列寧主義	列宁主义	Liè níng zhǔ yì	Leninism
列寧格勒	列宁格勒	Liè níng gé lè	Leningrad, name of Russian city Saint Petersburg 聖彼得堡|圣彼得堡 1923-1991
利眠寧	利眠宁	lì mián níng	chlordiazepoxide/(trade name) Librium (loanword)
加里寧格勒	加里宁格勒	Jiā lǐ níng gé lè	Kaliningrad, town on Baltic now in Russian republic/formerly Königsberg, capital of East Prussia
加里寧格勒州	加里宁格勒州	Jiā lǐ níng gé lè zhōu	Kaliningrad Oblast
勃朗寧	勃朗宁	Bó lǎng níng	Browning, US firearm brand
南寧	南宁	Nán níng	Nanning prefecture level city and capital of Guangxi Zhuang autonomous region in south China 廣西壯族自治區|广西壮族自治区
南寧地區	南宁地区	Nán níng dì qū	Nanning prefecture in Guangxi Zhuang autonomous region in south China 廣西壯族自治區|广西壮族自治区
南寧市	南宁市	Nán níng Shì	Nanning prefecture level city and capital of Guangxi Zhuang autonomous region 廣西壯族自治區|广西壮族自治区[Guǎng xī Zhuàng zú Zì zhì qū] in south China
周寧	周宁	Zhōu níng	Zhouning county in Ningde 寧德|宁德[Níng dé], Fujian
周寧縣	周宁县	Zhōu níng xiàn	Zhouning county in Ningde 寧德|宁德[Níng dé], Fujian
咸寧	咸宁	Xián níng	Xianning prefecture level city in Hubei
咸寧地區	咸宁地区	Xián níng dì qū	Xianning prefecture in Hubei
咸寧市	咸宁市	Xián níng shì	Xianning prefecture level city in Hubei
唐寧街	唐宁街	Táng níng Jiē	Downing Street (London)
單寧酸	单宁酸	dān níng suān	tannic acid (loanword)
坐臥不寧	坐卧不宁	zuò wò bù nìng	to be restless
壽寧	寿宁	Shòu níng	Shouning county in Ningde 寧德|宁德[Níng dé], Fujian
壽寧縣	寿宁县	Shòu níng xiàn	Shouning county in Ningde 寧德|宁德[Níng dé], Fujian
大寧	大宁	Dà níng	Daning county in Linfen 臨汾|临汾[Lín fén], Shanxi
大寧縣	大宁县	Dà níng xiàn	Daning county in Linfen 臨汾|临汾[Lín fén], Shanxi
天寧	天宁	Tiān níng	Tianning district of Changzhou city 常州市[Cháng zhōu shì], Jiangsu
天寧區	天宁区	Tiān níng qū	Tianning district of Changzhou city 常州市[Cháng zhōu shì], Jiangsu
奎寧	奎宁	kuí níng	quinine (loanword)
奎寧水	奎宁水	kuí níng shuǐ	tonic water/quinine water
威寧彞族回族苗族自治縣	威宁彝族回族苗族自治县	Wēi níng Yí zú Huí zú Miáo zú Zì zhì xiàn	Weining Yi, Hui and Miao autonomous county in Bijie prefecture 畢節地區|毕节地区[Bì jié dì qū], Guizhou
威寧縣	威宁县	Wēi níng xiàn	Weining Yi, Hui and Miao autonomous county in Bijie prefecture 畢節地區|毕节地区[Bì jié dì qū], Guizhou
安寧	安宁	Ān níng	Anning District of Lanzhou City 蘭州市|兰州市[Lán zhōu Shì], Gansu/Anning City, to the west of Kunming 昆明[Kūn míng], Yunnan
安寧	安宁	ān níng	peaceful/tranquil/calm/composed/free from worry
安寧區	安宁区	Ān níng Qū	Anning District of Lanzhou City 蘭州市|兰州市[Lán zhōu Shì], Gansu
安寧市	安宁市	Ān níng shì	Anning county level city in Kunming 昆明[Kūn míng], Yunnan
安寧片	安宁片	ān níng piàn	meprobamate
安寧病房	安宁病房	ān níng bìng fáng	hospice
富寧	富宁	Fù níng	Funing county in Wenshan Zhuang and Miao autonomous prefecture 文山壯族苗族自治州|文山壮族苗族自治州[Wén shān Zhuàng zú Miáo zú zì zhì zhōu], Yunnan
富寧縣	富宁县	Fù Níng xiàn	Funing county in Wenshan Zhuang and Miao autonomous prefecture 文山壯族苗族自治州|文山壮族苗族自治州[Wén shān Zhuàng zú Miáo zú zì zhì zhōu], Yunnan
丁寧	丁宁	dīng níng	variant of 叮嚀|叮咛[dīng níng]
不自由，毋寧死	不自由，毋宁死	bù zì yóu , wú nìng sǐ	give me liberty or give me death
中寧	中宁	Zhōng níng	Zhongning county in Zhongwei 中衛|中卫[Zhōng wèi], Ningxia
寧做雞頭，不做鳳尾	宁做鸡头，不做凤尾	nìng zuò jī tóu , bù zuò fèng wěi	lit. would rather be a chicken's head than a phoenix's tail (idiom)/fig. to prefer to be a big fish in a small pond rather than a small fish in a big pond
寧化	宁化	Níng huà	Ninghua county in Sanming 三明[Sān míng], Fujian
寧化縣	宁化县	Níng huà xiàn	Ninghua county in Sanming 三明[Sān míng], Fujian
寧南	宁南	Níng nán	Ningnan county in Liangshan Yi autonomous prefecture 涼山彞族自治州|凉山彝族自治州[Liáng shān Yí zú zì zhì zhōu], south Sichuan
寧南縣	宁南县	Níng nán xiàn	Ningnan county in Liangshan Yi autonomous prefecture 涼山彞族自治州|凉山彝族自治州[Liáng shān Yí zú zì zhì zhōu], south Sichuan
寧可	宁可	nìng kě	preferably/one would prefer to...(or not to...)/would rather/(would) be better to/(to pick) the lesser of two evils
寧國	宁国	Níng guó	Ningguo county level city in Xuancheng 宣城[Xuān chéng], Anhui
寧國市	宁国市	Níng guó shì	Ningguo county level city in Xuancheng 宣城[Xuān chéng], Anhui
寧城	宁城	Níng chéng	Ningcheng county of Chifeng 赤峰, Inner Mongolia
寧城縣	宁城县	Níng chéng xiàn	Ningcheng county of Chifeng 赤峰, Inner Mongolia
寧夏	宁夏	Níng xià	Ningxia Hui Autonomous Region, abbr. 寧|宁[Níng], capital Yinchuan 銀川|银川[Yín chuān]
寧夏回族自治區	宁夏回族自治区	Níng xià Huí zú Zì zhì qū	Ningxia Hui Autonomous Region, abbr. 寧|宁[Níng], capital Yinchuan 銀川|银川[Yíng chuān]
寧夏省	宁夏省	Níng xià Shěng	former Ningxia province, now Ningxia Hui Autonomous Region 寧夏回族自治區|宁夏回族自治区[Níng xià Huí zú Zì zhì qū]
寧安	宁安	Níng ān	Ning'an county level city in Mudanjiang 牡丹江, Heilongjiang
寧安市	宁安市	Níng ān shì	Ning'an county level city in Mudanjiang 牡丹江, Heilongjiang
寧宗	宁宗	Níng zōng	Emperor Ningzong of Southern Song (1168-1224)
寧岡	宁冈	Níng gāng	former Ninggang county in Jiangxi, now within Jinggangshan county level city 井岡山市|井冈山市[Jǐng gāng shān shì] in Ji'an 吉安, Jiangxi
寧岡縣	宁冈县	Níng gāng xiàn	former Ninggang county in Jiangxi, now within Jinggangshan county level city 井岡山市|井冈山市[Jǐng gāng shān shì] in Ji'an 吉安, Jiangxi
寧左勿右	宁左勿右	nìng zuǒ wù yòu	(of one's political views) to prefer left rather than right (idiom during the Cultural Revolution)
寧強	宁强	Níng qiáng	Ningqiang County in Hanzhong 漢中|汉中[Hàn zhōng], Shaanxi
寧強縣	宁强县	Níng qiáng Xiàn	Ningqiang County in Hanzhong 漢中|汉中[Hàn zhōng], Shaanxi
寧德	宁德	Níng dé	Ningde prefecture level city in Fujian
寧德地區	宁德地区	Níng dé dì qū	Ningde prefecture in Fujian
寧德市	宁德市	Níng dé shì	Ningde prefecture level city in Fujian
寧拆十座廟，不毀一樁婚	宁拆十座庙，不毁一桩婚	níng chāi shí zuò miào , bù huì yī zhuāng hūn	rather destroy ten temples than a single marriage (idiom)
寧明	宁明	Níng míng	Ningming county in Chongzuo 崇左[Chóng zuǒ], Guangxi
寧明縣	宁明县	Níng míng xiàn	Ningming county in Chongzuo 崇左[Chóng zuǒ], Guangxi
寧晉	宁晋	Níng jìn	Ningjin county in Xingtai 邢台[Xíng tái], Hebei
寧晉縣	宁晋县	Níng jìn xiàn	Ningjin county in Xingtai 邢台[Xíng tái], Hebei
寧武	宁武	Níng wǔ	Ningwu county in Xinzhou 忻州[Xīn zhōu], Shanxi
寧武縣	宁武县	Níng wǔ xiàn	Ningwu county in Xinzhou 忻州[Xīn zhōu], Shanxi
寧死不屈	宁死不屈	nìng sǐ bù qū	rather die than submit (idiom)
寧江	宁江	Níng jiāng	Ningjiang district of Songyuan city 松原市, Jilin
寧江區	宁江区	Níng jiāng qū	Ningjiang district of Songyuan city 松原市, Jilin
寧河	宁河	Níng hé	Ninghe county in Tianjin 天津[Tiān jīn]
寧河縣	宁河县	Níng hé xiàn	Ninghe county in Tianjin 天津[Tiān jīn]
寧波	宁波	Níng bō	Ningbo subprovincial city in Zhejiang
寧波地區	宁波地区	Níng bō dì qū	Ningbo prefecture, Zhejiang
寧波市	宁波市	Níng bō shì	Ningbo subprovincial city in Zhejiang
寧津	宁津	Níng jīn	Ningjin county in Dezhou 德州[Dé zhōu], Shandong
寧津縣	宁津县	Níng jīn xiàn	Ningjin county in Dezhou 德州[Dé zhōu], Shandong
寧洱	宁洱	Níng ěr	Ning'er County in Yunnan/abbr. for Ning'er Hani and Yi Autonomous County 寧洱哈尼族彞族自治縣|宁洱哈尼族彝族自治县[Níng ěr Hā ní zú Yí zú Zì zhì xiàn]
寧洱哈尼族彞族自治縣	宁洱哈尼族彝族自治县	Níng ěr Hā ní zú Yí zú Zì zhì xiàn	Ning'er Hani and Yi Autonomous County in Yunnan, capital Pu'er city 普洱市[Pǔ ěr shì]/formerly Pu'er Hani and Yi autonomous county
寧洱縣	宁洱县	Níng ěr Xiàn	Ning'er County in Yunnan/abbr. for Ning'er Hani and Yi Autonomous County 寧洱哈尼族彞族自治縣|宁洱哈尼族彝族自治县[Níng ěr Hā ní zú Yí zú Zì zhì xiàn]
寧海	宁海	Níng hǎi	Ninghai county in Ningbo 寧波|宁波[Níng bō], Zhejiang
寧海縣	宁海县	Níng hǎi xiàn	Ninghai county in Ningbo 寧波|宁波[Níng bō], Zhejiang
寧為玉碎，不為瓦全	宁为玉碎，不为瓦全	nìng wéi yù suì , bù wéi wǎ quán	Better broken jade than intact tile./Death is preferable to dishonor. (idiom)
寧為雞頭，不為鳳尾	宁为鸡头，不为凤尾	nìng wéi jī tóu , bù wéi fèng wěi	see 寧做雞頭，不做鳳尾|宁做鸡头，不做凤尾[nìng zuò jī tóu , bù zuò fèng wěi]
寧縣	宁县	Níng xiàn	Ning county in Qingyang 慶陽|庆阳[Qìng yáng], Gansu
寧缺勿濫	宁缺勿滥	nìng quē wù làn	same as 寧缺毋濫|宁缺毋滥[nìng quē wú làn]
寧缺毋濫	宁缺毋滥	nìng quē wú làn	better to have nothing (than substandard choice) (idiom); would prefer to go without than accept shoddy option
寧肯	宁肯	nìng kěn	would rather.../it would be better.../would prefer
寧蒗	宁蒗	Níng làng	abbr. for 寧蒗彞族自治縣|宁蒗彝族自治县, Ninglang Yizu autonomous county in Yunnan
寧蒗彞族自治縣	宁蒗彝族自治县	Níng làng Yí zú Zì zhì xiàn	Ninglang Yizu Autonomous County in Lijiang 麗江|丽江[Lì jiāng], Yunnan
寧蒗縣	宁蒗县	Níng làng xiàn	Ninglang Yizu autonomous county in Lijiang 麗江|丽江[Lì jiāng], Yunnan
寧遠	宁远	Níng yuǎn	Ningyuan county in Yongzhou 永州[Yǒng zhōu], Hunan
寧遠縣	宁远县	Níng yuǎn xiàn	Ningyuan county in Yongzhou 永州[Yǒng zhōu], Hunan
寧邊	宁边	Níng biān	Yongbyon (Ryeongbyeon), site of North Korean nuclear reactor
寧都	宁都	Níng dū	Ningdu county in Ganzhou 贛州|赣州, Jiangxi
寧都縣	宁都县	Níng dū xiàn	Ningdu county in Ganzhou 贛州|赣州, Jiangxi
寧鄉	宁乡	Níng xiāng	Ningxiang county in Changsha 長沙|长沙[Cháng shā], Hunan
寧鄉縣	宁乡县	Níng xiāng xiàn	Ningxiang county in Changsha 長沙|长沙[Cháng shā], Hunan
寧陝	宁陕	Níng shǎn	Ningshan County in Ankang 安康[Ān kāng], Shaanxi
寧陝縣	宁陕县	Níng shǎn Xiàn	Ningshan County in Ankang 安康[Ān kāng], Shaanxi
寧陵	宁陵	Níng líng	Ningling county in Shangqiu 商丘[Shāng qiū], Henan
寧陵縣	宁陵县	Níng líng xiàn	Ningling county in Shangqiu 商丘[Shāng qiū], Henan
寧陽	宁阳	Níng yáng	Ningyang county in Tai'an 泰安[Tài ān], Shandong
寧陽縣	宁阳县	Níng yáng xiàn	Ninguang county in Tai'an 泰安[Tài ān], Shandong
寧靜	宁静	níng jìng	tranquil/tranquility/serenity
寧靜致遠	宁静致远	níng jìng zhì yuǎn	tranquility yields transcendence (idiom); quiet life of profound study/cf Still waters run deep.
寧願	宁愿	nìng yuàn	would rather/better
巴枯寧主義	巴枯宁主义	Bā kū níng zhǔ yì	Bakuninism, a 19th century socialist theory
席凡寧根	席凡宁根	Xí fán níng gēn	Scheveningen, resort in Den Haag (The Hague), Netherlands
常寧	常宁	Cháng níng	Changning county level city in Hengyang 衡陽|衡阳[Héng yáng], Hunan
常寧市	常宁市	Cháng níng shì	Changning county level city in Hengyang 衡陽|衡阳[Héng yáng], Hunan
廣寧	广宁	Guǎng níng	Guangning county in Zhaoqing 肇慶|肇庆[Zhào qìng], Guangdong
廣寧縣	广宁县	Guǎng níng xiàn	Guangning county in Zhaoqing 肇慶|肇庆[Zhào qìng], Guangdong
建寧	建宁	Jiàn níng	Jianning county in Sanming 三明[Sān míng], Fujian
建寧縣	建宁县	Jiàn níng xiàn	Jianning county in Sanming 三明[Sān míng], Fujian
張寧	张宁	Zhāng Níng	Zhang Ning (1975-), PRC female badminton player and Olympic gold medalist
張怡寧	张怡宁	Zhāng Yí níng	Zhang Yining (1981-), PRC female table tennis player and Olympic gold medalist
心神不寧	心神不宁	xīn shén bù níng	to feel ill at ease
心緒不寧	心绪不宁	xīn xù bù níng	unquiet state of mind
息事寧人	息事宁人	xī shì níng rén	to keep the peace; to patch up a quarrel (idiom)
懷寧	怀宁	Huái níng	Huaining county in Anqing 安慶|安庆[Ān qìng], Anhui
懷寧縣	怀宁县	Huái níng xiàn	Huaining county in Anqing 安慶|安庆[Ān qìng], Anhui
撫寧	抚宁	Fǔ níng	Funing county in Qinhuangdao 秦皇島|秦皇岛[Qín huáng dǎo], Hebei
撫寧縣	抚宁县	Fǔ níng xiàn	Funing county in Qinhuangdao 秦皇島|秦皇岛[Qín huáng dǎo], Hebei
新寧	新宁	Xīn níng	Xinning county in Shaoyang 邵陽|邵阳[Shào yáng], Hunan
新寧縣	新宁县	Xīn níng xiàn	Xinning county in Shaoyang 邵陽|邵阳[Shào yáng], Hunan
昌寧	昌宁	Chāng níng	Changning county in Baoshan 保山[Bǎo shān], Yunnan
昌寧縣	昌宁县	Chāng níng xiàn	Changning county in Baoshan 保山[Bǎo shān], Yunnan
晉寧	晋宁	Jìn níng	Jinning county in Kunming 昆明[Kūn míng], Yunnan
晉寧縣	晋宁县	Jìn níng xiàn	Jinning county in Kunming 昆明[Kūn míng], Yunnan
普寧	普宁	Pǔ níng	Puning county level city in Jieyang 揭陽|揭阳, Guangdong
普寧市	普宁市	Pǔ níng shì	Puning county level city in Jieyang 揭陽|揭阳, Guangdong
景寧	景宁	Jǐng níng	Jingning Shezu autonomous county in Lishui 麗水|丽水[Lí shuǐ], Zhejiang
景寧畬族自治縣	景宁畲族自治县	Jǐng níng Shē zú Zì zhì xiàn	Jingning Shezu autonomous county in Lishui 麗水|丽水[Lí shuǐ], Zhejiang
景寧畬鄉	景宁畲乡	Jǐng níng Shē xiāng	Jingning Shezu autonomous county in Lishui 麗水|丽水[Lí shuǐ], Zhejiang
景寧縣	景宁县	Jǐng níng xiàn	Jingning Shezu autonomous county in Lishui 麗水|丽水[Lí shuǐ], Zhejiang
會寧	会宁	Huì níng	Huining county in Baiyin 白銀|白银[Bái yín], Gansu
會寧縣	会宁县	Huì níng xiàn	Huining county in Baiyin 白銀|白银[Bái yín], Gansu
李寧	李宁	Lǐ Níng	Li Ning (1963-), PRC gymnast, winner of three gold medals at Los Angeles 1984 Olympic games
東寧	东宁	Dōng níng	Dongning county in Mudanjiang 牡丹江, Heilongjiang
東寧縣	东宁县	Dōng níng xiàn	Dongning county in Mudanjiang 牡丹江, Heilongjiang
格羅寧根	格罗宁根	Gé luó níng gēn	Groningen, province and city in the Netherlands
楊振寧	杨振宁	Yáng Zhèn nìng	Chen-Ning Franklin Yang (1922-), theoretical physicist, co-developer of Yang-Mills gauge theory, 1957 Nobel laureate
正寧	正宁	Zhèng níng	Zhengning county in Qingyang 慶陽|庆阳[Qìng yáng], Gansu
正寧縣	正宁县	Zhèng níng xiàn	Zhengning county in Qingyang 慶陽|庆阳[Qìng yáng], Gansu
武寧	武宁	Wǔ níng	Wuning county in Jiujiang 九江, Jiangxi
武寧縣	武宁县	Wǔ níng xiàn	Wuning county in Jiujiang 九江, Jiangxi
歸寧	归宁	guī níng	(literary) (of a married woman) to visit one's parents
毋寧	毋宁	wú nìng	not as good as/would rather
永寧	永宁	Yǒng níng	Yongning county in Yinchuan 銀川|银川[Yín chuān], Ningxia
永寧縣	永宁县	Yǒng níng xiàn	Yongning county in Yinchuan 銀川|银川[Yín chuān], Ningxia
永無寧日	永无宁日	yǒng wú níng rì	(in such circumstances) there will be no peace/one can never breathe easy
江寧	江宁	Jiāng níng	Jiangning district of Nanjing City 南京市 in Jiangsu 江蘇|江苏
江寧區	江宁区	Jiāng níng qū	Jiangning district of Nanjing City 南京市 in Jiangsu 江蘇|江苏
泰寧	泰宁	Tài níng	Taining county in Sanming 三明[Sān míng], Fujian
泰寧縣	泰宁县	Tài níng xiàn	Taining county in Sanming 三明[Sān míng], Fujian
洛寧	洛宁	Luò níng	Luoning county in Luoyang 洛陽|洛阳, Henan
洛寧縣	洛宁县	Luò Níng xiàn	Luoning county in Luoyang 洛陽|洛阳, Henan
海寧	海宁	Hǎi níng	Haining county level city in Jiaxing 嘉興|嘉兴[Jiā xīng], Zhejiang
海寧市	海宁市	Hǎi níng shì	Haining county level city in Jiaxing 嘉興|嘉兴[Jiā xīng], Zhejiang
滅蟲寧	灭虫宁	miè chóng nìng	bephenium, anti-parasitic worm medicine
滬寧	沪宁	Hù Níng	Shanghai and Nanjing
滬寧線	沪宁线	Hù Níng xiàn	Shanghai-Nanjing line
滬寧鐵路	沪宁铁路	Hù Níng Tiě lù	Shanghai-Nanjing Railway, a.k.a. Huning Railway
濟寧	济宁	Jǐ níng	Jining prefecture-level city in Shandong
濟寧地區	济宁地区	Jǐ níng dì qū	Jining prefecture in Shandong
濟寧市	济宁市	Jǐ níng shì	Jining prefecture-level city in Shandong
無寧	无宁	wú nìng	variant of 毋寧|毋宁[wú nìng]
睢寧	睢宁	Suī níng	Suining county in Xuzhou 徐州[Xú zhōu], Jiangsu
睢寧縣	睢宁县	Suī níng xiàn	Suining county in Xuzhou 徐州[Xú zhōu], Jiangsu
綏寧	绥宁	Suí níng	Suining county in Shaoyang 邵陽|邵阳[Shào yáng], Hunan
綏寧縣	绥宁县	Suí níng xiàn	Suining county in Shaoyang 邵陽|邵阳[Shào yáng], Hunan
肅寧	肃宁	Sù níng	Suning county in Cangzhou 滄州|沧州[Cāng zhōu], Hebei
肅寧縣	肃宁县	Sù níng xiàn	Suning county in Cangzhou 滄州|沧州[Cāng zhōu], Hebei
興寧	兴宁	Xīng níng	Xingning county level city in Meizhou 梅州, Guangdong/Xingning District of Nanning City 南寧市|南宁市[Nán níng Shì], Guangxi
興寧區	兴宁区	Xīng níng Qū	Xingning District of Nanning City 南寧市|南宁市[Nán níng Shì], Guangxi
興寧市	兴宁市	Xīng níng shì	Xingning county level city in Meizhou 梅州, Guangdong
華寧	华宁	Huá níng	Huaning county in Yuxi 玉溪[Yù xī], Yunnan
華寧縣	华宁县	Huá níng xiàn	Huaning county in Yuxi 玉溪[Yù xī], Yunnan
萬寧	万宁	Wàn níng	Wanning City, Hainan
萬寧市	万宁市	Wàn níng shì	Wanning City, Hainan
蘇寧電器	苏宁电器	Sū níng diàn qì	Suning Appliance (PRC electrical retailer)
西寧	西宁	Xī níng	Xining prefecture level city and capital of Qinghai province 青海省[Qīng hǎi shěng] in west China
西寧市	西宁市	Xī níng shì	Xining prefecture level city and capital of Qinghai province 青海省[Qīng hǎi shěng] in west China
豐寧	丰宁	Fēng níng	Fengning Manchu autonomous county in Chengde 承德[Chéng dé], Hebei
豐寧滿族自治縣	丰宁满族自治县	Fēng níng Mǎn zú Zì zhì xiàn	Fengning Manchu Autonomous County in Chengde 承德[Chéng dé], Hebei
豐寧縣	丰宁县	Fēng níng xiàn	Fengning Manchu autonomous county in Chengde 承德[Chéng dé], Hebei
貝寧	贝宁	Bèi níng	Benin
遂寧	遂宁	Suì níng	Suining prefecture level city in Sichuan
遂寧市	遂宁市	Suì níng shì	Suining prefecture level city in Sichuan
遼寧	辽宁	Liáo níng	Liaoning province in northeast China, short name 遼|辽[Liáo], capital Shenyang 瀋陽|沈阳[Shěn yáng]
遼寧古盜鳥	辽宁古盗鸟	Liáo níng gǔ dào niǎo	Archaeoraptor liaoningensis (bird-like dinosaur found in Liaoning province)
遼寧大學	辽宁大学	Liáo níng Dà xué	Liaoning University
遼寧省	辽宁省	Liáo níng shěng	Liaoning province in northeast China, short name 遼|辽[Liáo], capital Shenyang 瀋陽|沈阳[Shěn yáng]
遼寧號	辽宁号	Liáo níng Hào	Liaoning, the first aircraft carrier commissioned into the PLA Navy (commissioned in 2012)
邕寧	邕宁	Yōng níng	Yongnning District of Nanning City 南寧市|南宁市[Nán níng Shì], Guangxi
邕寧區	邕宁区	Yōng níng Qū	Yongnning District of Nanning City 南寧市|南宁市[Nán níng Shì], Guangxi
郎世寧	郎世宁	Láng shì níng	Giuseppe Castiglione (1688-1766) Jesuit who served as Qing court painter for 50 years
鄉寧	乡宁	Xiāng níng	Xiangning county in Linfen 臨汾|临汾[Lín fén], Shanxi
鄉寧縣	乡宁县	Xiāng níng xiàn	Xiangning county in Linfen 臨汾|临汾[Lín fén], Shanxi
金寧	金宁	Jīn níng	Chinning township in Kinmen County 金門縣|金门县[Jīn mén xiàn] (Kinmen or Quemoy islands), Taiwan
金寧鄉	金宁乡	Jīn níng xiāng	Chinning township in Kinmen County 金門縣|金门县[Jīn mén xiàn] (Kinmen or Quemoy islands), Taiwan
鎮寧布依族苗族自治縣	镇宁布依族苗族自治县	Zhèn níng Bù yī zú Miáo zú Zì zhì xiàn	Zhenning Buyei and Hmong autonomous county in Anshun 安順|安顺[Ān shùn], Guizhou
鎮寧縣	镇宁县	Zhèn níng xiàn	Zhenning Buyei and Hmong autonomous county in Anshun 安順|安顺[Ān shùn], Guizhou
長寧	长宁	Cháng níng	Changning County in Yibin 宜賓|宜宾[Yí bīn], Sichuan/Changning District in Shanghai
長寧區	长宁区	Cháng níng qū	Changning district, central Shanghai
長寧縣	长宁县	Cháng níng xiàn	Changning county in Yibin 宜賓|宜宾[Yí bīn], Sichuan
阜寧	阜宁	Fù níng	Funing county in Yancheng 鹽城|盐城[Yán chéng], Jiangsu
阜寧縣	阜宁县	Fù níng xiàn	Funing county in Yancheng 鹽城|盐城[Yán chéng], Jiangsu
陝甘寧	陕甘宁	Shǎn Gān Níng	Shaanxi, Gansu and Ningxia provinces
集寧	集宁	Jí níng	Jining district or Zhining raion of Ulaanchab city 烏蘭察布市|乌兰察布市[Wū lán chá bù shì], Inner Mongolia
集寧區	集宁区	Jí níng qū	Jining district or Zhining raion of Ulaanchab city 烏蘭察布市|乌兰察布市[Wū lán chá bù shì], Inner Mongolia
雞犬不寧	鸡犬不宁	jī quǎn bù níng	lit. not even the chickens and dogs are left undisturbed (idiom)/fig. great commotion/pandemonium
靜寧	静宁	Jìng níng	Jingning county in Pingliang 平涼|平凉[Píng liáng], Gansu
靜寧縣	静宁县	Jìng níng xiàn	Jingning county in Pingliang 平涼|平凉[Píng liáng], Gansu
馬克思列寧主義	马克思列宁主义	Mǎ kè sī Liè níng zhǔ yì	Marxism-Leninism
