細	细	xì	thin or slender/finely particulate/thin and soft/fine/delicate/trifling/(of a sound) quiet/frugal
中性粒細胞	中性粒细胞	zhōng xìng lì xì bāo	neutrophil (the most common type of white blood cell)
事無巨細	事无巨细	shì wú jù xì	lit. things are not separated according to their size (idiom)/fig. to deal with any matter, regardless of its importance
亞細亞	亚细亚	Yà xì yà	Asia
亞細亞洲	亚细亚洲	Yà xì yà Zhōu	Asia/abbr. to 亞洲|亚洲[Yà zhōu]
亞細安	亚细安	Yà xì ān	ASEAN
仔細	仔细	zǐ xì	careful/attentive/cautious
低聲細語	低声细语	dī shēng xì yǔ	in a whisper/in a low voice (idiom)
備細	备细	bèi xì	details/particulars
傾耳細聽	倾耳细听	qīng ěr xì tīng	to prick up one's ear and listen carefully
內細胞團	内细胞团	nèi xì bāo tuán	inner cell mass (ICM)
卵母細胞	卵母细胞	luǎn mǔ xì bāo	egg cell
原核細胞	原核细胞	yuán hé xì bāo	prokaryote/prokaryotic cell
原核細胞型微生物	原核细胞型微生物	yuán hé xì bāo xíng wēi shēng wù	prokaryotic cell type microorganism
吞噬細胞	吞噬细胞	tūn shì xì bāo	phagocyte (cell that ingests and destroys foreign matter)
呢喃細語	呢喃细语	ní nán xì yǔ	whispering in a low voice (idiom); murmuring
單核細胞	单核细胞	dān hé xì bāo	monocyte/mononuclear cell
單核細胞增多症	单核细胞增多症	dān hé xì bāo zēng duō zhèng	mononucleosis
單細胞	单细胞	dān xì bāo	single-celled (organism)/unicellular
單細胞生物	单细胞生物	dān xì bāo shēng wù	single-celled organism
嗜酸性粒細胞	嗜酸性粒细胞	shì suān xìng lì xì bāo	eosinophil (type of white blood cell)
嗜鹼性粒細胞	嗜碱性粒细胞	shì jiǎn xìng lì xì bāo	basophil granulocytes (rarest type of white blood cell)
基底細胞癌	基底细胞癌	jī dǐ xì bāo ái	basal cell carcinoma
多形核白細胞	多形核白细胞	duō xíng hé bái xì bāo	polymorphonuclear leukocyte
多細胞	多细胞	duō xì bāo	multicellular
多細胞生物	多细胞生物	duō xì bāo shēng wù	multicellular life form
大吞噬細胞	大吞噬细胞	dà tūn shì xì bāo	macrophage
奸細	奸细	jiān xi	a spy/a crafty person
子細	子细	zǐ xì	variant of 仔細|仔细[zǐ xì]
子細胞	子细胞	zǐ xì bāo	daughter cell
小亞細亞	小亚细亚	Xiǎo yà xì yà	Asia minor/Anatolia
小吞噬細胞	小吞噬细胞	xiǎo tūn shì xì bāo	microphage (a type of white blood cell)
尖細	尖细	jiān xì	taper
巨噬細胞	巨噬细胞	jù shì xì bāo	macrophage
巨細	巨细	jù xì	big and small
巨細胞病毒	巨细胞病毒	jù xì bāo bìng dú	cytomegalovirus (CMV)
巨細胞病毒視網膜炎	巨细胞病毒视网膜炎	jù xì bāo bìng dú shì wǎng mó yán	cytomegalovirus retinitis, a disease of the retina that can lead to blindness/CMV retinitis
幹細胞	干细胞	gàn xì bāo	stem cell
底細	底细	dǐ xì	inside information/the ins and outs of the matter/how things stand/what's up
微細	微细	wēi xì	microminiature (technology)
微細加工	微细加工	wēi xì jiā gōng	microminiature technology
心細	心细	xīn xì	careful/scrupulous
性細胞	性细胞	xìng xì bāo	sexual cell/germline cell/gamete
慢工出細貨	慢工出细货	màn gōng chū xì huò	patient work makes a fine product
挾細拿粗	挟细拿粗	xié xì ná cū	to provoke
明細	明细	míng xì	clear and detailed/definite/details (are as follows:)
明細表	明细表	míng xì biǎo	schedule/subsidiary ledger/a detailed list
極細小	极细小	jí xì xiǎo	extremely small/infinitesimal
樹狀細胞	树状细胞	shù zhuàng xì bāo	dendritic cell
樹突狀細胞	树突状细胞	shù tū zhuàng xì bāo	dendritic cell
毛細	毛细	máo xì	capillary
毛細孔	毛细孔	máo xì kǒng	pore
毛細血管	毛细血管	máo xì xuè guǎn	capillary blood vessels
氰基細菌	氰基细菌	qíng jī xì jūn	cyanobacteria
淋巴細胞	淋巴细胞	lín bā xì bāo	lymphocyte
深耕細作	深耕细作	shēn gēng xì zuò	deep plowing and careful cultivation
瀟瀟細雨	潇潇细雨	xiāo xiāo xì yǔ	the sound of light rain or drizzle (idiom)
燃料元件細棒	燃料元件细棒	rán liào yuán jiàn xì bàng	fuel pins
瑣細	琐细	suǒ xì	trivial
生殖細胞	生殖细胞	shēng zhí xì bāo	germ cell/reproductive cell
癌細胞	癌细胞	ái xì bāo	cancer cell
白細胞	白细胞	bái xì bāo	white blood cell/leukocyte
神經細胞	神经细胞	shén jīng xì bāo	nerve cell/neuron
神經膠質細胞	神经胶质细胞	shén jīng jiāo zhì xì bāo	glial cell (provide support to neuron)/neuroglia
粒白細胞	粒白细胞	lì bái xì bāo	white granulocyte (blood cell)
粒細胞	粒细胞	lì xì bāo	granulocyte
粗細	粗细	cū xì	thick and thin/coarse and fine/thickness (caliber)/coarseness/quality of work
精打細算	精打细算	jīng dǎ xì suàn	meticulous planning and careful accounting (idiom)
精挑細選	精挑细选	jīng tiāo xì xuǎn	to select very carefully
精細	精细	jīng xì	fine/meticulous/careful
精耕細作	精耕细作	jīng gēng xì zuò	intensive farming
精雕細刻	精雕细刻	jīng diāo xì kè	lit. fine sculpting (idiom); fig. to work with extreme care and precision
紅細胞	红细胞	hóng xì bāo	erythrocyte/red blood cell
紅細胞沉降率	红细胞沉降率	hóng xì bāo chén jiàng lǜ	erythrocyte sedimentation rate (ESR)
中亞細亞	中亚细亚	Zhōng Yà xì yà	Central Asia
細作	细作	xì zuò	police spy/secret agent
細分	细分	xì fēn	subdivision/segmentation
細則	细则	xì zé	detailed rules and regulations/bylaws
細化	细化	xì huà	to give a more granular level of detail/to elaborate/to refine/to become more differentiated
細化管理	细化管理	xì huà guǎn lǐ	micromanagement
細嘴短趾百靈	细嘴短趾百灵	xì zuǐ duǎn zhǐ bǎi líng	(bird species of China) Hume's short-toed lark (Calandrella acutirostris)
細嘴鷗	细嘴鸥	xì zuǐ ōu	(bird species of China) slender-billed gull (Chroicocephalus genei)
細嘴黃鸝	细嘴黄鹂	xì zuǐ huáng lí	(bird species of China) slender-billed oriole (Oriolus tenuirostris)
細嚼慢嚥	细嚼慢咽	xì jiáo màn yàn	to eat slowly (idiom)
細大不捐	细大不捐	xì dà bù juān	not to discard anything, whether small or big (idiom)/all-embracing
細姨	细姨	xì yí	concubine
細嫩	细嫩	xì nèn	tender
細密	细密	xì mì	fine (texture)/meticulous/close (analysis)/detailed
細察	细察	xì chá	to observe carefully
細小	细小	xì xiǎo	tiny/fine/minute
細尾獴	细尾獴	xì wěi měng	meerkat/see 狐獴[hú měng]
細微	细微	xì wēi	tiny/minute/fine/subtle/sensitive (instruments)
細微末節	细微末节	xì wēi mò jié	tiny insignificant details/niceties
細心	细心	xì xīn	careful/attentive
細挑	细挑	xì tiāo	slender
細支氣管炎	细支气管炎	xì zhī qì guǎn yán	bronchiolitis
細數	细数	xì shǔ	countdown/breakdown/to list/to enumerate/to run through
細明體	细明体	Xì míng tǐ	Mincho narrow font
細枝末節	细枝末节	xì zhī mò jié	minor details/trifles
細毛	细毛	xì máo	fuzz/fine fur (of marten etc)
細水長流	细水长流	xì shuǐ cháng liú	lit. thin streams flow forever/fig. economy will get you a long way/to work steadily at something little by little
細沙	细沙	xì shā	fine sand
細河	细河	Xì hé	Xihe river in Fuxin/Xihe district of Fuxin city 阜新市, Liaoning
細河區	细河区	Xì hé qū	Xihe district of Fuxin city 阜新市, Liaoning
細潤	细润	xì rùn	fine and glossy
細皮嫩肉	细皮嫩肉	xì pí nèn ròu	soft skin and tender flesh (idiom)/smooth-skinned
細目	细目	xì mù	detailed listing/specific item
細看	细看	xì kàn	to peer/to scan/to examine carefully
細碎	细碎	xì suì	fragments/bits and pieces
細磨刀石	细磨刀石	xì mò dāo shí	whetstone (for honing knives)
細究	细究	xì jiū	to look into (a matter)
細節	细节	xì jié	details/particulars
細粉	细粉	xì fěn	powder
細粒	细粒	xì lì	fine grain/fine-grained
細紋噪鶥	细纹噪鹛	xì wén zào méi	(bird species of China) streaked laughingthrush (Trochalopteron lineatum)
細紋葦鶯	细纹苇莺	xì wén wěi yīng	(bird species of China) speckled reed warbler (Acrocephalus sorghophilus)
細細品味	细细品味	xì xì pǐn wèi	to savor/to relish
細細地流	细细地流	xì xì de liú	to trickle
細線	细线	xì xiàn	string/thread
細緻	细致	xì zhì	delicate/fine/careful/meticulous/painstaking
細繩	细绳	xì shéng	string/twine/cord
細聲細氣	细声细气	xì shēng xì qì	in a fine voice (idiom); softly spoken
細聽	细听	xì tīng	to listen carefully (for tiny sounds)
細胞	细胞	xì bāo	cell (biology)
細胞分裂	细胞分裂	xì bāo fēn liè	cell division
細胞周期	细胞周期	xì bāo zhōu qī	cell cycle
細胞器	细胞器	xì bāo qì	organelle
細胞器官	细胞器官	xì bāo qì guān	organelle
細胞因子	细胞因子	xì bāo yīn zǐ	cytokine
細胞培養	细胞培养	xì bāo péi yǎng	cell culture
細胞培養器	细胞培养器	xì bāo péi yǎng qì	cell cultivator
細胞壁	细胞壁	xì bāo bì	cell wall
細胞外液	细胞外液	xì bāo wài yè	extracellular fluid
細胞學	细胞学	xì bāo xué	cytology
細胞核	细胞核	xì bāo hé	nucleus (of cell)
細胞毒	细胞毒	xì bāo dú	cytotoxin
細胞毒性	细胞毒性	xì bāo dú xìng	cytotoxicity
細胞生物學	细胞生物学	xì bāo shēng wù xué	cell biology
細胞破碎	细胞破碎	xì bāo pò suì	(biotechnology) cell disruption
細胞膜	细胞膜	xì bāo mó	cell membrane
細胞色素	细胞色素	xì bāo sè sù	cytochrome
細胞融合	细胞融合	xì bāo róng hé	cell fusion
細胞質	细胞质	xì bāo zhì	cytoplasm
細胞骨架	细胞骨架	xì bāo gǔ jià	cytoskeleton (of a cell)
細腰	细腰	xì yāo	slender waist/fig. pretty woman/mortise and tenon joint on a coffin
細膩	细腻	xì nì	exquisite/meticulous
細菌	细菌	xì jūn	bacterium/germ
細菌性痢疾	细菌性痢疾	xì jūn xìng lì jí	bacillary dysentery
細菌戰	细菌战	xì jūn zhàn	biological warfare/germ warfare
細菌武器	细菌武器	xì jūn wǔ qì	biological weapon (using germs)
細菌病毒	细菌病毒	xì jūn bìng dú	bacteriophage/virus that infects bacteria
細菌群	细菌群	xì jūn qún	bacterial community (e.g. in the gut)
細葉脈	细叶脉	xì yè mài	veinlet in a leaf
細語	细语	xì yǔ	to chat with a low voice
細說	细说	xì shuō	to tell in detail
細調	细调	xì diào	to fine tune
細軟	细软	xì ruǎn	fine and soft/valuables
細辛	细辛	xì xīn	Manchurian wild ginger (family Asarum)
細部	细部	xì bù	small part (of a whole ensemble)/detail
細長	细长	xì cháng	slender
細雨	细雨	xì yǔ	fine rain/drizzle/poem by Tang poet Li Shangyin 李商隱|李商隐
細頸瓶	细颈瓶	xì jǐng píng	jug
細顆粒物	细颗粒物	xì kē lì wù	fine particle (PM 2.5)/fine particulate matter (air pollution etc)
細香蔥	细香葱	xì xiāng cōng	chive
細鹽	细盐	xì yán	refined salt/table salt
纖細	纤细	xiān xì	fine/slim/tender
腦細胞	脑细胞	nǎo xì bāo	brain cell
藍細菌	蓝细菌	lán xì jūn	Cyanobacteria (blue-green algae)
血細胞	血细胞	xuè xì bāo	blood cell
許旺細胞	许旺细胞	Xǔ wàng xì bāo	Schwann cell (support axon of nerve cell)/neurolemmocyte
詳細	详细	xiáng xì	detailed/in detail/minute
輕聲細語	轻声细语	qīng shēng xì yǔ	to speak softly/to whisper (idiom)
輕言細語	轻言细语	qīng yán xì yǔ	to speak softly
造血幹細胞	造血干细胞	zào xuè gàn xì bāo	blood generating stem cells (in bone marrow)
過細	过细	guò xì	extremely careful/meticulous/overattentive
鐮刀細胞貧血	镰刀细胞贫血	lián dāo xì bāo pín xuè	sickle cell anemia
鐮狀細胞血症	镰状细胞血症	lián zhuàng xì bāo xuè zhèng	sickle cell anemia
間充質幹細胞	间充质干细胞	jiān chōng zhì gàn xì bāo	mesenchymal stem cell MSC (in cell biology)
類鼻疽單細胞	类鼻疽单细胞	lèi bí jū dān xì bāo	Pseudomonas pseudomallei
食不厭精，膾不厭細	食不厌精，脍不厌细	shí bù yàn jīng , kuài bù yàn xì	lit. to eat but finely ground grain and finely chopped meat (idiom, from Analects)/fig. to be fastidious about one's food
體細胞	体细胞	tǐ xì bāo	somatic cell
鱗狀細胞癌	鳞状细胞癌	lín zhuàng xì bāo ái	squamous cell carcinoma
