活	活	huó	to live/alive/living/work/workmanship
你死我活	你死我活	nǐ sǐ wǒ huó	lit. you die, I live (idiom); irreconcilable adversaries/two parties cannot coexist
做活	做活	zuò huó	to work for a living (esp. of woman needleworker)/life of a group of stones in Go 圍棋|围棋[wéi qí]
做活兒	做活儿	zuò huó r5	erhua variant of 做活[zuò huó]
做生活	做生活	zuò shēng huó	to work/to do manual labor
全活	全活	quán huó	to save life/to rescue/the whole business with all its processes
公益活動	公益活动	gōng yì huó dòng	charity event/public service activities
再活化假說	再活化假说	zài huó huà jiǎ shuō	reactivation hypothesis
出活	出活	chū huó	to finish a job on time/to produce the goods
包活	包活	bāo huó	job paid according to the amount of work done/contract work
口活	口活	kǒu huó	oral sex
品味生活	品味生活	pǐn wèi shēng huó	to appreciate life
哭得死去活來	哭得死去活来	kū de sǐ qù huó lái	to cry one's heart out
地震活動帶	地震活动带	dì zhèn huó dòng dài	seismic zone/earthquake belt
夜生活	夜生活	yè shēng huó	night life
太陽活動	太阳活动	tài yáng huó dòng	sunspot activity/solar variation
好死不如賴活著	好死不如赖活着	hǎo sǐ bù rú lài huó zhe	better a bad life than a good death (idiom)
存活	存活	cún huó	to survive (a serious accident)/survival
存活率	存活率	cún huó lǜ	(med.) survival rate/(med.) recovery rate
守活寡	守活寡	shǒu huó guǎ	to stay at home while one's husband is away/grass widow
寄生生活	寄生生活	jì shēng shēng huó	parasitism/parasitic life-style
審美活動	审美活动	shěn měi huó dòng	appreciating the arts/esthetic activity
幹活	干活	gàn huó	to work/to be employed
幹活兒	干活儿	gàn huó r5	erhua variant of 幹活|干活[gàn huó]
復活	复活	fù huó	to revive/(lit. and fig.) to come back to life/(religion) resurrection
復活的軍團	复活的军团	Fù huó de jūn tuán	the Resurrected Army (CCTV documentary series about the Terracotta army)
復活節	复活节	Fù huó jié	Easter
復活節島	复活节岛	Fù huó jié Dǎo	Easter Island
復活賽	复活赛	fù huó sài	repechage (supplementary qualifying round in sports)
忙活	忙活	máng huo	to be really busy/pressing business
快活	快活	kuài huo	happy/cheerful
性生活	性生活	xìng shēng huó	sex life
愛得死去活來	爱得死去活来	ài de sǐ qù huó lái	to be madly in love
成活	成活	chéng huó	to survive
成活率	成活率	chéng huó lǜ	survival rate/rate of success
手活	手活	shǒu huó	manipulation (e.g. ball handling in sport)/hand job
拉活	拉活	lā huó	(northern dialect) to pick up a fare (as a taxi driver)/to pick up a piece of work (as a courier)
拼死拼活	拼死拼活	pīn sǐ pīn huó	one's utmost/(to fight or work) desperately hard/to put up a life or death struggle/at all costs
接活	接活	jiē huó	to take on a piece of work/to pick up some freelance work/(of a taxi driver) to pick up a fare
搞活	搞活	gǎo huó	to enliven/to invigorate/to revitalize
放射性活度	放射性活度	fàng shè xìng huó dù	radioactivity
政治生活	政治生活	zhèng zhì shēng huó	political life
救活	救活	jiù huó	to bring back to life
文康活動	文康活动	wén kāng huó dòng	cultural and recreational activities (Tw)
料件子活	料件子活	liào jiàn zi huó	piecework
有活力	有活力	yǒu huó lì	energetic/vital
樂活	乐活	lè huó	LOHAS (lifestyles of health and sustainability)
死去活來	死去活来	sǐ qù huó lái	to hover between life and death (idiom)/to suffer terribly/within an inch of one's life
死活	死活	sǐ huó	life or death/fate/no matter what/anyway/for the life of me
死活不顧	死活不顾	sǐ huó bù gù	regardless of life or death (idiom)
死要面子活受罪	死要面子活受罪	sǐ yào miàn zi huó shòu zuì	to go through hell for the sake of keeping up appearances (idiom)
死馬當活馬醫	死马当活马医	sǐ mǎ dàng huó mǎ yī	lit. to give medicine to a dead horse (idiom)/fig. to keep trying everything in a desperate situation
不知死活	不知死活	bù zhī sǐ huó	to act recklessly (idiom)
活下	活下	huó xià	to survive
活下去	活下去	huó xià qù	to survive/to keep on living
活不下去	活不下去	huó bù xià qu	impossible to make a living
活久見	活久见	huó jiǔ jiàn	(neologism c. 2006) if you live long enough, you'll see everything/Just incredible!
活人	活人	huó rén	living person
活人讓尿憋死	活人让尿憋死	huó rén ràng niào biē sǐ	lit. such a fool as to die from holding in one's pee (idiom)/fig. unable to solve a problem due to the inflexibility of one's thinking
活似	活似	huó sì	see 活像[huó xiàng]
活佛	活佛	huó fó	Living Buddha/title of Mongolian Lamas from 17th century
活便	活便	huó biàn	nimble/agile/convenient
活像	活像	huó xiàng	to look exactly like/to be the spitting image of
活兒	活儿	huó r5	work/(lots of) things to do
活分	活分	huó fēn	nimble
活到老，學到老	活到老，学到老	huó dào lǎo , xué dào lǎo	One is never too old to learn. (idiom)
活力	活力	huó lì	energy/vitality/vigor/vital force
活力四射	活力四射	huó lì sì shè	dynamic/enthusiastic/energetic
活動	活动	huó dòng	to exercise/to move about/to operate/to use connections (personal influence)/loose/shaky/active/movable/activity/campaign/maneuver/behavior/CL:項|项[xiàng],個|个[gè]
活動中心	活动中心	huó dòng zhōng xīn	activity center/CL:處|处[chù]
活動人士	活动人士	huó dòng rén shì	activist
活動家	活动家	huó dòng jiā	activist
活動房	活动房	huó dòng fáng	prefabricated building/prefab
活動房屋	活动房屋	huó dòng fáng wū	prefabricated building/prefab/mobile home/caravan/trailer
活動扳手	活动扳手	huó dòng bān shǒu	adjustable spanner
活動掛圖	活动挂图	huó dòng guà tú	flipchart
活動曲尺	活动曲尺	huó dòng qū chǐ	sliding bevel (to measure angles)
活動桌面	活动桌面	huó dòng zhuō miàn	active desktop
活動看板	活动看板	huó dòng kàn bǎn	calendar of events
活動能力	活动能力	huó dòng néng lì	mobility/motility
活化	活化	huó huà	activation
活化分析	活化分析	huó huà fēn xī	activation analysis
活化石	活化石	huó huà shí	living fossil
活受罪	活受罪	huó shòu zuì	(coll.) to go through sheer hell
活命	活命	huó mìng	life/to survive/to save a life/to scrape a living
活埋	活埋	huó mái	to bury alive
活報劇	活报剧	huó bào jù	political street theater (loanword from Zhivaya Gazeta, or Living Newspaper, Russian theater form of the 1920s)
活塞	活塞	huó sāi	piston/valve
活套	活套	huó tào	noose/running knot
活字	活字	huó zì	movable type
活字典	活字典	huó zì diǎn	walking dictionary/well-informed person
活字印刷	活字印刷	huó zì yìn shuā	printing with movable type
活存	活存	huó cún	demand deposit (abbr. for 活期存款[huó qī cún kuǎn])
活學活用	活学活用	huó xué huó yòng	to creatively combine learning with usage/to learn and apply pragmatically
活寶	活宝	huó bǎo	buffoon/clown/ridiculous person
活度	活度	huó dù	activity
活得不耐煩	活得不耐烦	huó de bù nài fán	to be tired of living/(coll.) to be asking for trouble
活性	活性	huó xìng	(chemistry) activity/active/activated
活性劑	活性剂	huó xìng jì	reagent (chemistry)
活性氧類	活性氧类	huó xìng yǎng lèi	activated oxygen species (AOS)
活性炭	活性炭	huó xìng tàn	activated carbon
活摘	活摘	huó zhāi	to harvest (an organ) from a living person
活期	活期	huó qī	(banking) current (account)/checking (account)/demand (deposit etc)
活期存款	活期存款	huó qī cún kuǎn	demand deposit
活期帳戶	活期帐户	huó qī zhàng hù	current account (in bank)
活期貸款	活期贷款	huó qī dài kuǎn	demand loan (i.e. loan that the borrower can demanded back at any time)
活期資金	活期资金	huó qī zī jīn	funds on call/invested sum that can be cashed
活板	活板	huó bǎn	trapdoor
活檢	活检	huó jiǎn	biopsy/abbr. for 活體組織檢查|活体组织检查[huó tǐ zǔ zhī jiǎn chá]
活氣	活气	huó qì	spirited atmosphere
活泛	活泛	huó fan	flexible/adaptable
活活	活活	huó huó	while still alive/simply/totally
活潑	活泼	huó po	lively/vivacious/brisk/active/(chemistry) reactive
活火	活火	huó huǒ	flaming fire/flames
活火山	活火山	huó huǒ shān	active volcano
活版	活版	huó bǎn	typography/movable type
活版印刷	活版印刷	huó bǎn yìn shuā	printing with movable type/typesetting
活物	活物	huó wù	living animals
活瓣	活瓣	huó bàn	valve
活生生	活生生	huó shēng shēng	real (people)/living (artist)/while still alive (e.g. skinned alive)
活用	活用	huó yòng	to apply (knowledge etc) creatively and flexibly/to use a word flexibly (e.g. a noun as an adjective)
活神仙似	活神仙似	huó shén xiān sì	to live like the immortals (advertising real estate)
活禽	活禽	huó qín	poultry/live fowl
活組織檢查	活组织检查	huó zǔ zhī jiǎn chá	biopsy
活結	活结	huó jié	a slip-knot/a noose
活罪	活罪	huó zuì	suffering/hardship/living hell
活脫	活脱	huó tuō	remarkably alike
活脫脫	活脱脱	huó tuō tuō	remarkably alike
活茬	活茬	huó chá	farm work
活菩薩	活菩萨	huó pú sà	a living Buddha/fig. compassionate person/saint
活著	活着	huó zhe	alive
活血	活血	huó xuè	to improve blood circulation (Chinese medicine)
活血止痛	活血止痛	huó xuè zhǐ tòng	to invigorate blood circulation and alleviate pain (idiom)
活計	活计	huó jì	handicraft/needlework/work
活該	活该	huó gāi	(coll.) serve sb right/deservedly/ought/should
活路	活路	huó lù	through road/way out/way to survive/means of subsistence
活路	活路	huó lu	labor/physical work
活蹦亂跳	活蹦乱跳	huó bèng luàn tiào	to leap and frisk about (idiom); lively/healthy and active
活躍	活跃	huó yuè	active/lively/excited/to enliven/to brighten up
活躍份子	活跃分子	huó yuè fèn zǐ	activist
活門	活门	huó mén	valve
活雷鋒	活雷锋	huó Léi Fēng	selfless model citizen, just like Lei Feng 雷鋒|雷锋[Léi Fēng]
活靈活現	活灵活现	huó líng huó xiàn	living spirit, living image (idiom); true to life/vivid and realistic
活靶子	活靶子	huó bǎ zi	live target/target (of criticism etc)
活體	活体	huó tǐ	living body/live specimen
活體檢視	活体检视	huó tǐ jiǎn shì	biopsy
活體組織檢查	活体组织检查	huó tǐ zǔ zhī jiǎn chá	biopsy/abbr. to 活檢|活检[huó jiǎn]
活魚	活鱼	huó yú	fresh fish/living fish
活龍活現	活龙活现	huó lóng huó xiàn	living spirit, living image (idiom); true to life/vivid and realistic
減毒活疫苗	减毒活疫苗	jiǎn dú huó yì miáo	attenuated live vaccine
演活	演活	yǎn huó	(of an actor) to bring (one's character) to life/to act brilliantly
激活	激活	jī huó	to activate
火山活動	火山活动	huǒ shān huó dòng	volcanic activity/volcanism
生吞活剝	生吞活剥	shēng tūn huó bō	to swallow whole (idiom); fig. to apply uncritically
生拉活扯	生拉活扯	shēng lā huó chě	to wildly exaggerate the meaning of sth (idiom)
生活	生活	shēng huó	life/activity/to live/livelihood
生活作風	生活作风	shēng huó zuò fēng	behavior/conduct
生活垃圾	生活垃圾	shēng huó lā jī	domestic garbage
生活必需品	生活必需品	shēng huó bì xū pǐn	life's necessities
生活方式	生活方式	shēng huó fāng shì	way of life/lifestyle
生活水平	生活水平	shēng huó shuǐ píng	living standards
生活污水	生活污水	shēng huó wū shuǐ	domestic sewage
生活美學	生活美学	shēng huó měi xué	appreciation of the finer things in life
生活設施	生活设施	shēng huó shè shī	living facilities
生活費	生活费	shēng huó fèi	cost of living/living expenses/alimony
生活資料	生活资料	shēng huó zī liào	consumer goods/means of livelihood/means of subsistence/documents relating to sb's life
生活質料	生活质料	shēng huó zhì liào	consumer goods
生活闊綽	生活阔绰	shēng huó kuò chuò	a flashy lifestyle/to live it up
生活館	生活馆	shēng huó guǎn	living museum
生物活化性	生物活化性	shēng wù huó huà xìng	bioactivity
生龍活虎	生龙活虎	shēng lóng huó hǔ	lit. lively dragon and animated tiger (idiom)/fig. vigorous and lively
破壞活動	破坏活动	pò huài huó dòng	sabotage/subversive activities
社會活動	社会活动	shè huì huó dòng	social activity
神氣活現	神气活现	shén qì huó xiàn	arrogant appearance/smug appearance/to act condescending/to put on airs
票活	票活	piào huó	to work as amateur for no pay
私生活	私生活	sī shēng huó	private life
秘密活動	秘密活动	mì mì huó dòng	clandestine activities/covert operation
競選活動	竞选活动	jìng xuǎn huó dòng	(election) campaign
粗活	粗活	cū huó	unskilled labor/heavy manual work
精神生活	精神生活	jīng shén shēng huó	spiritual or moral life
累死累活	累死累活	lèi sǐ lèi huó	to tire oneself out through overwork/to work oneself to death
絕活	绝活	jué huó	specialty/unique skill
經濟活動	经济活动	jīng jì huó dòng	economic activity
維持生活	维持生活	wéi chí shēng huó	to subsist/to eke out a living/to keep body and soul together
羌活	羌活	qiāng huó	Notopterygium root (root of Notopterygium incisum)
肺活量	肺活量	fèi huó liàng	(medicine) vital capacity
自由活動	自由活动	zì yóu huó dòng	free time (between organized activities)
艙外活動	舱外活动	cāng wài huó dòng	extravehicular activity (outside space vehicle)/EVA
花活	花活	huā huó	trick/deception
苦活	苦活	kǔ huó	bitter work/sweated labor
苦活兒	苦活儿	kǔ huó r5	erhua variant of 苦活[kǔ huó]
莊稼活兒	庄稼活儿	zhuāng jia huó r5	farm work
表面活化劑	表面活化剂	biǎo miàn huó huà jì	surfactant
表面活性劑	表面活性剂	biǎo miàn huó xìng jì	surfactant
要死不活	要死不活	yào sǐ bù huó	half dead/more dead than alive
要死要活	要死要活	yào sǐ yào huó	terribly/awfully/desperately
討生活	讨生活	tǎo shēng huó	to eke out a living/to live from hand to mouth/to drift aimlessly
變活	变活	biàn huó	to come to life (by magic)
農事活動	农事活动	nóng shì huó dòng	agricultural activities
農活	农活	nóng huó	farm work
過活	过活	guò huó	to live one's life/to make a living
重活	重活	zhòng huó	heavy job
重活兒	重活儿	zhòng huó r5	erhua variant of 重活[zhòng huó]
重活化劑	重活化剂	zhòng huó huà jì	reactivator
針線活	针线活	zhēn xiàn huó	needlework/sewing
針線活兒	针线活儿	zhēn xiàn huó r5	needlework/working for a living as a needleworker
針線活計	针线活计	zhēn xiàn huó jì	needlework/sewing
鐵窗生活	铁窗生活	tiě chuāng shēng huó	time served in prison/prison life
間諜活動	间谍活动	jiàn dié huó dòng	espionage/spying
雜活	杂活	zá huó	odd jobs
靈活	灵活	líng huó	flexible/nimble/agile
靈活性	灵活性	líng huó xìng	flexibility
飯後一支煙，賽過活神仙	饭后一支烟，赛过活神仙	fàn hòu yī zhī yān , sài guò huó shén xiān	have a smoke after each meal and you will surpass the immortals (proverb)
飯後百步走，活到九十九	饭后百步走，活到九十九	fàn hòu bǎi bù zǒu , huó dào jiǔ shí jiǔ	walk a hundred steps after each meal and you will live a long life (proverb)
養家活口	养家活口	yǎng jiā huó kǒu	to support one's family (idiom)
養活	养活	yǎng huo	to provide for/to keep (animals, a family etc)/to raise animals/to feed and clothe/support/the necessities of life/to give birth
體育活動	体育活动	tǐ yù huó dòng	sports/sporting activity
鮮活	鲜活	xiān huó	vivid/lively/(of food ingredients) live or fresh
鮮活貨物	鲜活货物	xiān huó huò wù	live cargo
