津	津	jīn	saliva/sweat/a ferry crossing/a ford (river crossing)/abbr. for Tianjin 天津
京津冀	京津冀	Jīng Jīn Jì	Jing-Jin-Ji (Beijing, Tianjin and Hebei Province)
兩頰生津	两颊生津	liǎng jiá shēng jīn	mouth-watering/to whet one's appetite
利津	利津	Lì jīn	Lijin county in Dongying 東營|东营[Dōng yíng], Shandong
利津縣	利津县	Lì jīn xiàn	Lijin county in Dongying 東營|东营[Dōng yíng], Shandong
問津	问津	wèn jīn	to make inquiries/to show interest
夏津	夏津	Xià jīn	Xiajin county in Dezhou 德州[Dé zhōu], Shandong
夏津縣	夏津县	Xià jīn xiàn	Xiajin county in Dezhou 德州[Dé zhōu], Shandong
天津	天津	Tiān jīn	Tianjin, a municipality in northeast China, abbr. 津
天津外國語大學	天津外国语大学	Tiān jīn Wài guó yǔ Dà xué	Tianjin Foreign Studies University
天津大學	天津大学	Tiān jīn Dà xué	Tianjin University
天津市	天津市	Tiān jīn shì	Tianjin, a municipality in northeast China, abbr. 津
天津會議專條	天津会议专条	Tiān jīn huì yì zhuān tiáo	Tianjin agreement of 1885 between Li Hongzhang 李鴻章|李鸿章[Lǐ Hóng zhāng] and ITŌ Hirobumi 伊藤博文[Yī téng Bó wén] to pull Qing and Japanese troops out of Korea
天津條約	天津条约	Tiān jīn Tiáo yuē	Treaty of Tianjin of 1858, a sequence of unequal treaties 不平等條約|不平等条约 between Russia, USA, England, France and Qing China
天津環球金融中心	天津环球金融中心	Tiān jīn Huán qiú Jīn róng Zhōng xīn	Tianjin World Financial Center, skyscraper a.k.a. the Tianjin Tower or Jin Tower/abbr. to 津塔[Jīn tǎ]
孟津	孟津	Mèng jīn	Mengjin county in Luoyang 洛陽|洛阳, Henan
孟津縣	孟津县	Mèng jīn xiàn	Mengjin county in Luoyang 洛陽|洛阳, Henan
寧津	宁津	Níng jīn	Ningjin county in Dezhou 德州[Dé zhōu], Shandong
寧津縣	宁津县	Níng jīn xiàn	Ningjin county in Dezhou 德州[Dé zhōu], Shandong
布熱津斯基	布热津斯基	Bù rè jīn sī jī	Brzezinski (name)/Zbigniew Brzezinski (1928-2017), Polish-American academic and politician, US National Security Adviser 1977-1981
布爾津	布尔津	Bù ěr jīn	Burqin county or Burchin nahiyisi in Altay prefecture 阿勒泰地區|阿勒泰地区[Ā lè tài dì qū], Xinjiang
布爾津縣	布尔津县	Bù ěr jīn xiàn	Burqin county or Burchin nahiyisi in Altay prefecture 阿勒泰地區|阿勒泰地区[Ā lè tài dì qū], Xinjiang
平津戰役	平津战役	Píng jīn Zhàn yì	Pingjin Campaign (Nov 1948-Jan 1949), one of the three major campaigns by the People's Liberation Army near the end of the Chinese Civil War
延津	延津	Yán jīn	Yanjin county in Xinxiang 新鄉|新乡[Xīn xiāng], Henan
延津縣	延津县	Yán jīn xiàn	Yanjin county in Xinxiang 新鄉|新乡[Xīn xiāng], Henan
指點迷津	指点迷津	zhǐ diǎn mí jīn	to show sb how to get to the right path
新津	新津	Xīn jīn	Xinjin county in Chengdu 成都[Chéng dū], Sichuan
新津縣	新津县	Xīn jīn xiàn	Xinjin county in Chengdu 成都[Chéng dū], Sichuan
旗津	旗津	Qí jīn	Qijin or Chichin district of Kaohsiung city 高雄市[Gāo xióng shì], south Taiwan
旗津區	旗津区	Qí jīn qū	Qijin or Chichin district of Kaohsiung city 高雄市[Gāo xióng shì], south Taiwan
汗津津	汗津津	hàn jīn jīn	sweaty
江津	江津	Jiāng jīn	Jiangjin suburban district of Chongqing municipality, formerly in Sichuan
江津區	江津区	Jiāng jīn qū	Jiangjin suburban district of Chongqing municipality, formerly in Sichuan
河津	河津	Hé jīn	Hejin county level city in Yuncheng 運城|运城[Yùn chéng], Shanxi
河津市	河津市	Hé jīn shì	Hejin county level city in Yuncheng 運城|运城[Yùn chéng], Shanxi
京津	京津	Jīng Jīn	Beijing and Tianjin
津南	津南	Jīn nán	Jinnan suburban district of Tianjin municipality 天津市[Tiān jīn shì]
津南區	津南区	Jīn nán qū	Jinnan suburban district of Tianjin municipality 天津市[Tiān jīn shì]
津塔	津塔	Jīn tǎ	Jin Tower/abbr. for 天津環球金融中心|天津环球金融中心[Tiān jīn Huán qiú Jīn róng Zhōng xīn] Tianjin World Financial Center, skyscraper a.k.a. the Tianjin Tower
津島	津岛	Jīn dǎo	Tsushima, a city in Aichi prefecture, Japan
津巴布韋	津巴布韦	Jīn bā bù wéi	Zimbabwe
津市	津市	Jīn shì	Jinshi county level city in Changde 常德[Cháng dé], Hunan
津市市	津市市	Jīn shì shì	Jinshi county level city in Changde 常德[Cháng dé], Hunan
津梁	津梁	jīn liáng	lit. ferry bridge/fig. interim measure over some difficulty/a guide
津沽	津沽	Jīn gū	another name for Tianjin 天津
津津	津津	jīn jīn	enthusiastic/ardent/(with) great relish
津津有味	津津有味	jīn jīn yǒu wèi	with keen interest (idiom)/with great pleasure/with gusto/eagerly
津津樂道	津津乐道	jīn jīn lè dào	to discuss sth enthusiastically
津浪	津浪	jīn làng	tsunami/same as 海嘯|海啸
津液	津液	jīn yè	bodily fluids (general term in Chinese medicine)
津澤	津泽	jīn zé	fluids (esp. in plants)/sap
津要	津要	jīn yào	(literary) key location/key post (important job)
津貼	津贴	jīn tiē	allowance
清津市	清津市	Qīng jīn shì	Chongjin, capital of North Hamgyeong province 咸鏡北道|咸镜北道[Xián jìng běi dào], North Korea
無人問津	无人问津	wú rén wèn jīn	to be of no interest to anyone (idiom)
牛津	牛津	Niú jīn	Oxford (city in England)
牛津大學	牛津大学	Niú jīn Dà xué	University of Oxford
牛津群	牛津群	niú jīn qún	Oxfordshire (English county)
甜津津	甜津津	tián jīn jīn	sweet and delicious
益胃生津	益胃生津	yì wèi shēng jīn	to benefit the stomach and increase fluids (idiom)
要津	要津	yào jīn	key post
迷津	迷津	mí jīn	a maze/to lose the way/bewildering
魚津	鱼津	yú jīn	bubbles (literary)
鹹津津	咸津津	xián jīn jīn	nice and salty (taste)
鹹津津兒	咸津津儿	xián jīn jīn r5	erhua variant of 鹹津津|咸津津[xián jīn jīn]
鹽津	盐津	Yán jīn	Yanjin county in Zhaotong 昭通[Zhāo tōng], Yunnan
鹽津縣	盐津县	Yán jīn xiàn	Yanjin county in Zhaotong 昭通[Zhāo tōng], Yunnan
點津	点津	diǎn jīn	to solve a problem/to answer a question/(Internet) Q&A forum/advice column
