㟁	岸	àn	variant of 岸[àn]
岸	岸	àn	bank/shore/beach/coast/CL:個|个[gè]
偉岸	伟岸	wěi àn	imposing/upright and tall/outstanding/gigantic in stature
傲岸	傲岸	ào àn	proud/haughty
兩岸	两岸	liǎng àn	bilateral/both shores/both sides/both coasts/Taiwan and mainland
兩岸三地	两岸三地	liǎng àn sān dì	China, Taiwan, Hong Kong and Macau (media term used esp. since 1997)
兩岸對話	两岸对话	liǎng àn duì huà	bilateral talks
凹岸	凹岸	āo àn	concave bank
到岸價	到岸价	dào àn jià	cost, insurance, and freight (CIF) (transportation)
南岸	南岸	Nán àn	Nananqu district of central Chongqing municipality, formerly in Sichuan
南岸區	南岸区	Nán àn qū	Nananqu district of central Chongqing municipality, formerly in Sichuan
口岸	口岸	kǒu àn	a port for external trade/a trading or transit post on border between countries
堤岸	堤岸	dī àn	embankment/bank/levee
對岸	对岸	duì àn	opposite bank (of a body of water)
上岸	上岸	shàng àn	to go ashore/to climb ashore
岸上	岸上	àn shàng	ashore/on the riverbank
岸標	岸标	àn biāo	lighthouse/shore beacon
岸然	岸然	àn rán	solemn/serious
岸邊	岸边	àn biān	shore
崖岸	崖岸	yá àn	cliff/steep slope/fig. arrogant and difficult person
左岸	左岸	Zuǒ àn	Left Bank (in Paris)
彼岸	彼岸	bǐ àn	the other shore/(Buddhism) paramita
彼岸花	彼岸花	bǐ àn huā	red spider lily (Lycoris radiata)/cluster amaryllis
抵岸	抵岸	dǐ àn	to come ashore
拍岸	拍岸	pāi àn	to beat against the shore (of waves)
東海岸	东海岸	Dōng hǎi àn	East Coast
江岸	江岸	Jiāng àn	Jiang'an district of Wuhan city 武漢市|武汉市[Wǔ hàn shì], Hubei
江岸區	江岸区	Jiāng àn qū	Jiang'an district of Wuhan city 武漢市|武汉市[Wǔ hàn shì], Hubei
河岸	河岸	hé àn	riverside/river bank
沿岸	沿岸	yán àn	coastal area/littoral or riparian
沿岸地區	沿岸地区	yán àn dì qū	coastal area
海岸	海岸	hǎi àn	coastal/seacoast
海岸線	海岸线	hǎi àn xiàn	coastline/seaboard/shoreline
海岸警衛隊	海岸警卫队	hǎi àn jǐng wèi duì	coastguard
海岸護衛隊	海岸护卫队	hǎi àn hù wèi duì	coast guard
海峽兩岸關係協會	海峡两岸关系协会	Hǎi xiá Liǎng àn Guān xi Xié huì	PRC Association for Relations Across the Taiwan Straits (ARATS)
登岸	登岸	dēng àn	to go ashore/to disembark
美國海岸警衛隊	美国海岸警卫队	Měi guó Hǎi àn Jǐng wèi duì	United States Coast Guard
苦海無邊，回頭是岸	苦海无边，回头是岸	kǔ hǎi wú biān , huí tóu shì àn	The sea of bitterness has no bounds, turn your head to see the shore (idiom). Only Buddhist enlightenment can allow one to shed off the abyss of worldly suffering./Repent and ye shall be saved!
落水狗上岸	落水狗上岸	luò shuǐ gǒu shàng àn	like a dog who fell in the river and climbs out—shaking all over
象牙海岸	象牙海岸	Xiàng yá Hǎi àn	Côte d'Ivoire or Ivory Coast (Tw)
通商口岸	通商口岸	tōng shāng kǒu àn	treaty port, forced on Qing China by the 19th century Great Powers
道貌岸然	道貌岸然	dào mào àn rán	sanctimonious/dignified
隔岸觀火	隔岸观火	gé àn guān huǒ	to watch the fires burning across the river/to delay entering the fray until all others have been exhausted by fighting amongst themselves (idiom)
離岸	离岸	lí àn	offshore
離岸價	离岸价	lí àn jià	free on board (FOB) (transportation)
靠岸	靠岸	kào àn	(of a boat) to reach the shore/to pull toward shore/close to shore/landfall
駁岸	驳岸	bó àn	a low stone wall built along the water's edge to protect an embankment/revetment
高岸	高岸	gāo àn	in grand style/high bank
高岸深谷	高岸深谷	gāo àn shēn gǔ	high bank, deep valley (idiom); secluded location
黃金海岸	黄金海岸	Huáng jīn Hǎi àn	name of various places including Gold Coast (Australian city), Gold Coast (former British colony in Africa) and Costa Daurada (area on the coast of Catalonia, Spain)
