莫	莫	Mò	surname Mo
莫	莫	mò	do not/there is none who
一辭莫贊	一辞莫赞	yī cí mò zàn	left speechless by sth perfect (idiom)
切莫	切莫	qiè mò	you must not/Please don't.../be sure not to/on no account (do it)
卡西莫夫	卡西莫夫	Kǎ xī mò fū	Kasimov (town in Russia)
各人自掃門前雪，莫管他家瓦上霜	各人自扫门前雪，莫管他家瓦上霜	gè rén zì sǎo mén qián xuě , mò guǎn tā jiā wǎ shàng shuāng	sweep the snow from your own door step, don't worry about the frost on your neighbor's roof (idiom)
吉莫	吉莫	jí mò	(old) name of a kind of leather
哀莫大於心死	哀莫大于心死	āi mò dà yú xīn sǐ	nothing sadder than a withered heart (idiom attributed to Confucius by Zhuangzi 莊子|庄子[Zhuāng zǐ])/no greater sorrow than a heart that never rejoices/the worst sorrow is not as bad as an uncaring heart/nothing is more wretched than apathy
季莫申科	季莫申科	Jì mò shēn kē	Tymoshenko (name)/Yulia Tymoshenko (1960-), Ukrainian politician
家醜不可外傳，流言切莫輕信	家丑不可外传，流言切莫轻信	jiā chǒu bù kě wài chuán , liú yán qiè mò qīng xìn	Don't spread abroad the shame of the family, don't believe rumors lightly. (idiom)/Don't wash your dirty linen in public, don't listen to others' gossip.
尤利婭·季莫申科	尤利娅·季莫申科	Yóu lì yà · Jì mò shēn kē	Yulia Tymoshenko (1960-), Ukrainian politician
巴勒莫	巴勒莫	Bā lè mò	Palermo, Italy
巴莫	巴莫	Bā Mò	Ba Maw
後悔莫及	后悔莫及	hòu huǐ mò jí	too late for regrets (idiom); It is useless to repent after the event.
愛莫利維爾	爱莫利维尔	Ài mò lì wéi ěr	Emeryville, town on San Fransico bay, California
愛莫能助	爱莫能助	ài mò néng zhù	unable to help however much one would like to (idiom); Although we sympathize, there is no way to help you./My hands are tied.
拉什莫爾山	拉什莫尔山	Lā shí mò ěr Shān	Mt Rushmore National Memorial, South Dakota
拉茲莫夫斯基	拉兹莫夫斯基	Lā zī mò fū sī jī	Razumovsky (name)/Prince Andrey Kirillovich Razumovsky (1752-1836), Russian diplomat
拉莫斯	拉莫斯	Lā mò sī	(Philippine President Fidel) Ramos
是非莫辨	是非莫辨	shì fēi mò biàn	unable to distinguish right and wrong (idiom)
望塵莫及	望尘莫及	wàng chén mò jí	lit. to see only the other rider's dust and have no hope of catching up (idiom)/to be far inferior
百思莫解	百思莫解	bǎi sī mò jiě	see 百思不解[bǎi sī bù jiě]
真偽莫辨	真伪莫辨	zhēn wěi mò biàn	can't judge true or false (idiom); unable to distinguish the genuine from the fake/not to know whether to believe (what one reads in the news)
知子莫若父	知子莫若父	zhī zǐ mò ruò fù	nobody understands one's son better than his father (idiom)
神祕莫測	神秘莫测	shén mì mò cè	mystery/unfathomable/enigmatic
科莫多龍	科莫多龙	Kē mò duō lóng	Komodo dragon (Varanus komodoensis)
約莫	约莫	yuē mo	about/around/approximately
紹莫吉州	绍莫吉州	Shào mò jí zhōu	Somogy county in southwest Hungary, capital 考波什堡[Kǎo bō shí bǎo]
若要人不知，除非己莫為	若要人不知，除非己莫为	ruò yào rén bù zhī , chú fēi jǐ mò wéi	If you don't want anyone to know, don't do it (idiom). fig. If you do something bad, people will inevitably hear about it.
一夫當關，萬夫莫開	一夫当关，万夫莫开	yī fū dāng guān , wàn fū mò kāi	one man can hold the pass against ten thousand enemies (idiom)
一籌莫展	一筹莫展	yī chóu mò zhǎn	to be unable to find a solution/to be at wits' end
莫三比克	莫三比克	Mò sān bǐ kè	Mozambique (Tw)
莫不	莫不	mò bù	none doesn't/there is none who isn't/everyone
莫不是	莫不是	mò bù shì	probably/perhaps/could it be that...?
莫不然	莫不然	mò bù rán	equally true for (all the rest)/the same thing applies (for everyone)
莫不聞	莫不闻	mò bù wén	there is no-one who doesn't know that
莫不逾侈	莫不逾侈	mò bù yú chǐ	there is no-one who is not extravagant
莫伊謝耶夫	莫伊谢耶夫	Mò yī xiè yē fū	Moiseyev (name)/Igor Aleksandrovich Moiseyev (1906-2007), choreographer of folk dance and founder of Moiseyev dance company
莫伯日	莫伯日	Mò bó rì	Maubeuge (French city)
莫傑斯特	莫杰斯特	Mò jié sī tè	Modest (name)/Modeste (name)
莫克姆灣	莫克姆湾	Mò kè mǔ wān	Morecambe Bay
莫內	莫内	Mò nèi	Taiwan equivalent of 莫奈[Mò nài]
莫利森	莫利森	Mò lì sēn	Morrison (name)
莫力達瓦達斡爾族自治旗	莫力达瓦达斡尔族自治旗	Mò lì Dá wǎ Dá wò ěr zú Zì zhì qí	Morin Dawa Daur Autonomous Banner in Hulunbuir 呼倫貝爾|呼伦贝尔[Hū lún bèi ěr], Inner Mongolia
莫可名狀	莫可名状	mò kě míng zhuàng	indescribable (joy)/inexpressible (pleasure)
莫可奈何	莫可奈何	mò kě nài hé	see 無可奈何|无可奈何[wú kě nài hé]
莫可指數	莫可指数	mò kě zhǐ shǔ	countless/innumerable
莫吉托	莫吉托	Mò jí tuō	Mojito
莫名	莫名	mò míng	indescribable/ineffable
莫名其妙	莫名其妙	mò míng qí miào	(idiom) baffling/inexplicable
莫哈韋沙漠	莫哈韦沙漠	Mò hā wéi Shā mò	Mojave Desert, southwestern USA
莫塔馬灣	莫塔马湾	Mò tǎ mǎ Wān	Gulf of Martaban, Myanmar (Burma)
莫大	莫大	mò dà	greatest/most important
莫奈	莫奈	Mò nài	Claude Monet (1840-1926), French impressionist painter
莫如	莫如	mò rú	it would be better
莫尼卡·萊溫斯基	莫尼卡·莱温斯基	Mò ní kǎ · Lái wēn sī jī	Monica Lewinsky (1973-), former White House intern
莫扎特	莫扎特	Mò zhā tè	Wolfgang Amadeus Mozart (1756-1791), Austrian composer
莫扎里拉	莫扎里拉	mò zā lǐ lā	mozzarella (loanword)
莫拉萊斯	莫拉莱斯	Mò lā lái sī	Morales
莫斯特	莫斯特	Mò sī tè	Mousterian (a Palaeolithic culture)
莫斯科	莫斯科	Mò sī kē	Moscow, capital of Russia
莫明其妙	莫明其妙	mò míng qí miào	variant of 莫名其妙[mò míng qí miào]
莫札特	莫札特	Mò zhá tè	Wolfgang Amadeus Mozart (1756-1791), Austrian composer (Tw)
莫桑比克	莫桑比克	Mò sāng bǐ kè	Mozambique
莫泊桑	莫泊桑	Mò bó sāng	Guy de Maupassant (1850-1893), French novelist and short story writer
莫洛尼	莫洛尼	Mò luò ní	Moroni, capital of Comoros (Tw)
莫測高深	莫测高深	mò cè gāo shēn	enigmatic/beyond one's depth/unfathomable
莫爾斯	莫尔斯	Mò ěr sī	Morse (name)
莫爾斯電碼	莫尔斯电码	Mò ěr sī diàn mǎ	Morse code
莫爾茲比港	莫尔兹比港	Mò ěr zī bǐ gǎng	Port Moresby, capital of Papua New Guinea
莫罕達斯	莫罕达斯	Mò hǎn dá sī	Mohandas (name)
莫羅尼	莫罗尼	Mò luó ní	Moroni, capital of Comoros
莫耳	莫耳	mò ěr	(chemistry) mole (loanword) (Tw)
莫臥兒王朝	莫卧儿王朝	Mò wò ér Wáng cháo	Mughal or Mogul Dynasty (1526-1858)
莫衷一是	莫衷一是	mò zhōng yī shì	unable to reach a decision (idiom); cannot agree on the right choice/no unanimous decision/still a matter of discussion
莫言	莫言	Mò Yán	Mo Yan (1955-), Chinese novelist, winner of 2012 Nobel Prize in Literature
莫講	莫讲	mò jiǎng	let alone/not to speak of (all the others)
莫迪	莫迪	Mò dí	Modi (name)/Narendra Modi (1950-), Indian BJP (Bharatiya Janata Party or Indian People's Party) politician, Gujarat Chief Minister from 2001, PM from 2014
莫逆	莫逆	mò nì	very friendly/intimate
莫逆之交	莫逆之交	mò nì zhī jiāo	intimate friendship/bosom buddies
莫過於	莫过于	mò guò yú	nothing can surpass
莫里哀	莫里哀	Mò lǐ āi	Molière (1622-1673), French playwright and actor, master of comedy
莫霍洛維奇	莫霍洛维奇	Mò huò luò wéi qí	Andrija Mohorovichich or Mohorovičić (1857-1936), Croatian geologist and seismologist who discovered the Mohorovichich discontinuity or Moho
莫霍洛維奇不連續面	莫霍洛维奇不连续面	Mò huò luò wéi qí bù lián xù miàn	Moho (aka Mohorovičić discontinuity, the lower boundary of the earth's lithosphere)/abbr. to 莫霍面[Mò huò miàn]
莫霍面	莫霍面	Mò huò miàn	Moho (aka Mohorovičić discontinuity, the lower boundary of the earth's lithosphere)
莫非	莫非	mò fēi	can it be possible that/could it be
莫須有	莫须有	mò xū yǒu	groundless/baseless
莫高窟	莫高窟	Mò gāo kū	Mogao caves in Dunhuang 敦煌, Gansu
落莫	落莫	luò mò	variant of 落寞[luò mò]
諱莫如深	讳莫如深	huì mò rú shēn	important matter that must be kept secret (idiom); don't breathe a word of it to anyone!
變化莫測	变化莫测	biàn huà mò cè	unpredictable/changeable
變幻莫測	变幻莫测	biàn huàn mò cè	to change unpredictably/unpredictable/erratic/treacherous
貝爾莫潘	贝尔莫潘	Bèi ěr mò pān	Belmopan, capital of Belize
追悔莫及	追悔莫及	zhuī huǐ mò jí	too late for regrets (idiom); It is useless to repent after the event.
過而能改，善莫大焉	过而能改，善莫大焉	guò ér néng gǎi , shàn mò dà yān	If one can change after making a mistake, there is nothing better (idiom)
阿莫西林	阿莫西林	ā mò xī lín	amoxicillin (loanword)
阿西莫夫	阿西莫夫	Ā xī mò fū	Isaac Asimov (1920-1992), American author and biochemist
非你莫屬	非你莫属	fēi nǐ mò shǔ	it's yours exclusively (idiom)/you are the one/only you deserve it/only you can do it
鞭長莫及	鞭长莫及	biān cháng mò jí	lit. the whip cannot reach (idiom); beyond one's influence/too far to be able to help
高深莫測	高深莫测	gāo shēn mò cè	profound mystery
麥克德莫特	麦克德莫特	Mài kè dé mò tè	McDermott (name)
