納	纳	Nà	surname Na
納	纳	nà	to receive/to accept/to enjoy/to bring into/to pay (tax etc)/nano- (one billionth)/to reinforce sole of shoes or stockings by close sewing
交納	交纳	jiāo nà	to pay (taxes or dues)
伯納斯·李	伯纳斯·李	Bó nà sī · Lǐ	Sir Tim Berners-Lee (1955-), British computer scientist and co-creator of the World Wide Web
儒勒·凡爾納	儒勒·凡尔纳	Rú lè · Fán ěr nà	Jules Verne (1828-1905), French novelist specializing in science fiction and adventure stories, author of Around the World in Eighty Days 八十天环绕地球
冒納羅亞	冒纳罗亚	Mào nà luó yà	Moanalua, Hawaiian volcano
出納	出纳	chū nà	cashier/to receive and hand over payment/to lend and borrow books
出納員	出纳员	chū nà yuán	cashier/teller/treasurer
利納克斯	利纳克斯	Lì nà kè sī	Linux (operating systems)
利賓納	利宾纳	lì bīn nà	Ribena
加德納	加德纳	Jiā dé nà	Gardner (name)
加納	加纳	Jiā nà	Ghana
努納武特	努纳武特	Nǔ nà wǔ tè	Nunavut territory, Canada
勒維納斯	勒维纳斯	Lè wéi nà sī	Levinas (philosopher)
北卡羅來納	北卡罗来纳	Běi Kǎ luó lái nà	North Carolina, US state
北卡羅來納州	北卡罗来纳州	Běi Kǎ luó lái nà zhōu	North Carolina, US state
北馬里亞納	北马里亚纳	Běi Mǎ lǐ yà nà	Northern Mariana Islands
北馬里亞納群島	北马里亚纳群岛	Běi Mǎ lǐ yà nà Qún dǎo	Northern Mariana Islands
南卡羅來納	南卡罗来纳	Nán Kǎ luó lái nà	South Carolina, US state
南卡羅來納州	南卡罗来纳州	Nán Kǎ luó lái nà zhōu	South Carolina, US state
博茨瓦納	博茨瓦纳	Bó cí wǎ nà	Botswana
卡塔赫納	卡塔赫纳	Kǎ tǎ hè nà	Cartagena
卡納塔克邦	卡纳塔克邦	Kǎ nà tǎ kè bāng	Karnataka, southwest Indian state, capital Bangalore 班加羅爾|班加罗尔[Bān jiā luó ěr]/formerly Mysore
卡納維拉爾角	卡纳维拉尔角	Kǎ nà wéi lā ěr jiǎo	Cape Canaveral, Florida, home of Kennedy space center 肯尼迪航天中心[Kěn ní dí Háng tiān Zhōng xīn]
卡納維爾角	卡纳维尔角	Kǎ nà wéi ěr jiǎo	Cape Canaveral, Florida
卡納蕾	卡纳蕾	kǎ nà lěi	canelé (a French pastry) (loanword)
卡納達語	卡纳达语	Kǎ nà dá yǔ	Kannada (language)
卡羅利納	卡罗利纳	Kǎ luó lì nà	Carolina (Puerto Rico)
印地安納	印地安纳	Yìn dì ān nà	Indiana, US state
印地安納州	印地安纳州	Yìn dì ān nà zhōu	Indiana, US state
印第安納	印第安纳	Yìn dì ān nà	Indiana, US state
印第安納州	印第安纳州	Yìn dì ān nà zhōu	Indiana, US state
印第安納波利斯	印第安纳波利斯	Yìn dì ān nà bō lì sī	Indianapolis, Indiana
受納	受纳	shòu nà	to accept/to receive (tribute)
吐故納新	吐故纳新	tǔ gù nà xīn	lit. to breathe out stale air and breathe in fresh (idiom, from Zhuangzi 庄子); fig. to get rid of the old and bring in the new
吸納	吸纳	xī nà	to take in/to absorb/to admit/to accept
哂納	哂纳	shěn nà	(literary) please kindly accept
哈西納	哈西纳	Hā xī nà	Ms Sheikh Hasina (1947-), Bangladesh politician, prime minister 1996-2001 and from 2009
唐納	唐纳	Táng nà	Tanner or Donald (name)
唐納·川普	唐纳·川普	Táng nà · Chuān pǔ	(Tw) Donald Trump (1946-), American business magnate, US president 2017-
唐納德	唐纳德	Táng nà dé	Donald (name)
喀納斯湖	喀纳斯湖	Kā nà sī Hú	Kanas Lake in Xinjiang
喬納森	乔纳森	Qiáo nà sēn	Jonathan (name)
埃森納赫	埃森纳赫	Āi sēn nà hè	Eisenach (German city)
埃特納火山	埃特纳火山	Āi tè nà huǒ shān	Mt Etna, volcano in Italy
塞斯納	塞斯纳	Sāi sī nà	Cessna (US aviation company)
塞納河	塞纳河	Sāi nà Hé	Seine
奧克斯納德	奥克斯纳德	Ào kè sī nà dé	Oxnard, California
奧康納	奥康纳	Ào kāng nà	O'Connor (name)/Thomas Power O'Connor (1848-1929), Irish journalist and nationalist political leader
奧納西斯	奥纳西斯	Ào nà xī sī	Onassis (name)/Aristotle Onassis (1906-1975), Greek shipping magnate
姆巴巴納	姆巴巴纳	Mǔ bā bā nà	Mbabane, capital of Swaziland
威廉·福克納	威廉·福克纳	Wēi lián · Fú kè nà	William Faulkner (1897-1962), American novelist and poet
安納托利亞	安纳托利亚	Ān nà tuō lì yà	Anatolia, Asia minor
安納波利斯	安纳波利斯	Ān nà bō lì sī	Annapolis (place name)
完全歸納推理	完全归纳推理	wán quán guī nà tuī lǐ	inference by complete induction
容納	容纳	róng nà	to hold/to contain/to accommodate/to tolerate (different opinions)
富納富提	富纳富提	Fù nà fù tí	Funafuti, capital of Tuvalu
察納	察纳	chá nà	to investigate and accept
巴塞隆納	巴塞隆纳	Bā sài lóng nà	Barcelona (Tw)
巴特納	巴特纳	Bā tè nà	Batna, town in eastern Algeria
布吉納法索	布吉纳法索	Bù jí nà Fǎ suǒ	Burkina Faso (Tw)
布基納法索	布基纳法索	Bù jī nà Fǎ suǒ	Burkina Faso
庫納	库纳	kù nà	kuna (Croatian currency)
恩賈梅納	恩贾梅纳	Ēn jiǎ méi nà	N'Djamena, capital of Chad
悅納	悦纳	yuè nà	to find acceptable
愛留根納	爱留根纳	Ài liú gēn nà	Eriugena, John Scottus (c. 810-880) Irish poet, theologian, and philosopher of Neoplatonism
戛納	戛纳	Jiá nà	Cannes (France)
托馬斯·阿奎納	托马斯·阿奎纳	Tuō mǎ sī · Ā kuí nà	Thomas Aquinas (1225-1274), Italian Catholic priest in the Dominican Order, philosopher and theologian in the scholastic tradition
拉文納	拉文纳	Lā wén nà	Ravenna on the Adriatic coast of Italy
拉納卡	拉纳卡	Lā nà kǎ	Larnaca (city in Cyprus)/Larnaka
招賢納士	招贤纳士	zhāo xián nà shì	invite the talented and call the valorous (idiom); to recruit talent
招降納叛	招降纳叛	zhāo xiáng nà pàn	to recruit surrendered enemy and deserters (idiom); to gather together a gang of villains
按納	按纳	àn nà	variant of 按捺[àn nà]
採納	采纳	cǎi nà	to accept/to adopt
接納	接纳	jiē nà	to admit (to membership)
摩德納	摩德纳	Mó dé nà	Modena, Italy
摩納哥	摩纳哥	Mó nà gē	Monaco
收納	收纳	shōu nà	to receive/to accept/to take in/to hold
斯堪地納維亞	斯堪地纳维亚	Sī kān dì nà wéi yà	Scandinavia (Tw)
斯堪的納維亞	斯堪的纳维亚	Sī kān dì nà wéi yà	Scandinavia
昂納克	昂纳克	Áng nà kè	Honecker (name)/Erich Honecker (1912-1994), East German communist politician, party general secretary 1971-1989, tried for treason after German unification
時代華納	时代华纳	Shí dài Huá nà	Time Warner Inc., US media company
普里什蒂納	普里什蒂纳	Pǔ lǐ shí dì nà	Pristina, capital of Kosovo 科索沃
杜嘉班納	杜嘉班纳	Dù jiā bān nà	Dolce & Gabbana (fashion)
格拉納達	格拉纳达	Gé lā nà dá	Granada, Spain
格林納達	格林纳达	Gé lín nà dá	Grenada
格洛納斯	格洛纳斯	gé luò nà sī	GLONASS (Globalnaya Navigatsionaya Satelitnaya Sistema or Global Navigation Satellite System), the Russian equivalent of GPS
桑塔納	桑塔纳	Sāng tǎ nà	Santana (name)
梅納德	梅纳德	Méi nà dé	Maynard (name)
歐納西斯	欧纳西斯	Ōu nà xī sī	see 奧納西斯|奥纳西斯[Ào nà xī sī]
歸納	归纳	guī nà	to sum up/to summarize/to conclude from facts/induction (method of deduction in logic)
歸納推理	归纳推理	guī nà tuī lǐ	inductive reasoning
歸納法	归纳法	guī nà fǎ	induction (method of deduction in logic)
比特納	比特纳	Bǐ tè nà	(surname) Bittner or Büttner
波士尼亞與赫塞哥維納	波士尼亚与赫塞哥维纳	Bō shì ní yà yǔ Hè sè gē wéi nà	Bosnia and Herzegovina (Tw)
泰米爾納德	泰米尔纳德	Tài mǐ ěr Nà dé	Tamil Nadu, southeast Indian state, capital Chennai 欽奈|钦奈[Qīn nài]/formerly Madras state 馬德拉斯邦|马德拉斯邦[Mǎ dé lā sī bāng]
泰米爾納德邦	泰米尔纳德邦	Tài mǐ ěr Nà dé bāng	Tamil Nadu, southeast Indian state, capital Chennai 欽奈|钦奈[Qīn nài]/formerly Madras state 馬德拉斯邦|马德拉斯邦[Mǎ dé lā sī bāng]
海納百川	海纳百川	hǎi nà bǎi chuān	all rivers run into the sea/use different means to obtain the same result (idiom)
滯納	滞纳	zhì nà	overdue (payment)/in arrears
滯納金	滞纳金	zhì nà jīn	overdue fine/late fine
潘塔納爾	潘塔纳尔	Pān tǎ nà ěr	Pantanal (wetland area in Brazil)
玉龍納西族自治縣	玉龙纳西族自治县	Yù lóng Nà xī zú Zì zhì xiàn	Yulong Naxi autonomous county in Lijiang 麗江|丽江[Lì jiāng], Yunnan
瑪納斯	玛纳斯	Mǎ nà sī	Manas, hero of Kyrghiz epic saga/Manas county and town in Changji Hui autonomous prefecture 昌吉回族自治州[Chāng jí Huí zú zì zhì zhōu], Xinjiang
瑪納斯河	玛纳斯河	Mǎ nà sī Hé	Manas River, Xinjiang
瑪納斯縣	玛纳斯县	Mǎ nà sī xiàn	Manas county in Changji Hui autonomous prefecture 昌吉回族自治州[Chāng jí Huí zú zì zhì zhōu], Xinjiang
瑪納斯鎮	玛纳斯镇	Mǎ nà sī zhèn	Manas town in Changji Hui autonomous prefecture 昌吉回族自治州[Chāng jí Huí zú zì zhì zhōu], Xinjiang
瓜拿納	瓜拿纳	guā ná nà	guarana (Paullinia cupana)
瓜田不納履，李下不整冠	瓜田不纳履，李下不整冠	guā tián bù nà lǚ , lǐ xià bù zhěng guān	lit. don't tie your shoelaces in a melon patch, and don't adjust your hat under a plum tree (idiom)/fig. don't do anything that might arouse suspicion/innocent acts may be misconstrued
瓜達卡納爾島	瓜达卡纳尔岛	Guā dá kǎ nà ěr dǎo	Guadalcanal Island
瓜達卡納爾戰役	瓜达卡纳尔战役	Guā dá kǎ nà ěr zhàn yì	battle of Guadalcanal of late 1942, the turning point of the war in the Pacific
瓦利斯和富圖納	瓦利斯和富图纳	Wǎ lì sī hé Fù tú nà	Wallis and Futuna (French island collectivity in the South Pacific)
瓦爾納	瓦尔纳	Wǎ ěr nà	Varna (city in Bulgaria)
甘納許	甘纳许	gān nà xǔ	ganache (loanword)
甘納豆	甘纳豆	gān nà dòu	amanattō, traditional Japanese sweets made from azuki or other beans
田納西	田纳西	Tián nà xī	Tennessee
田納西州	田纳西州	Tián nà xī zhōu	Tennessee
盧比安納	卢比安纳	Lú bǐ ān nà	Ljubljana, capital of Slovenia (Tw)
真納	真纳	Zhēn nà	(Mohammad Ali) Jinnah (founder of Pakistan)
砷凡納明	砷凡纳明	shēn fán nà míng	arsphenamine
福克納	福克纳	Fú kè nà	William Faulkner (1897-1962), American novelist and poet
科利奧蘭納斯	科利奥兰纳斯	Kē lì ào lán nà sī	Coriolanus, 1607 tragedy by William Shakespeare 莎士比亞|莎士比亚
科納克里	科纳克里	Kē nà kè lǐ	Conakry, capital of Guinea
科羅納	科罗纳	Kē luó nà	Corona/Colonna
笑納	笑纳	xiào nà	to kindly accept (an offering)
第納爾	第纳尔	dì nà ěr	dinar (currency) (loanword)
米納爾迪	米纳尔迪	mǐ nà ěr dí	Minardi, Formula 1 racing team
約納	约纳	Yuē nà	Jonah
不完全歸納推理	不完全归纳推理	bù wán quán guī nà tuī lǐ	inference by incomplete induction
亞利桑納州	亚利桑纳州	Yà lì sāng nà zhōu	state of Arizona
納什	纳什	Nà shí	Nash (surname)
納什維爾	纳什维尔	Nà shí wéi ěr	Nashville, capital of Tennessee
納傑夫	纳杰夫	Nà jié fū	Najaf (city in Iraq, a Shia holy city)
納入	纳入	nà rù	to bring into/to channel into/to integrate into/to incorporate
納匝肋	纳匝肋	Nà zā lèi	Nazareth
納吉布	纳吉布	Nà jí bù	Muhammad Naguib (1901-1984), first president of the Republic of Egypt
納塔乃耳	纳塔乃耳	Nà tǎ nǎi ěr	Nathaniel
納妾	纳妾	nà qiè	to take a concubine
納寵	纳宠	nà chǒng	to take a concubine
納尼	纳尼	nà ní	(Internet slang) what? (loanword from Japanese 何 なに nani)
納尼亞	纳尼亚	Nà ní yà	Narnia, children's fantasy world in stories by C.S. Lewis
納尼亞傳奇	纳尼亚传奇	Nà ní yà Chuán qí	The Chronicles of Narnia, children's stories by C.S. Lewis
納德阿里	纳德阿里	Nà dé Ā lǐ	Nad Ali, town in Helmand province, Afghanistan
納悶	纳闷	nà mèn	puzzled/bewildered
納悶兒	纳闷儿	nà mèn r5	erhua variant of 納悶|纳闷[nà mèn]
納扎爾巴耶夫	纳扎尔巴耶夫	Nà zhā ěr bā yē fū	Nursultan Nazarbayev (1940-), president of Kazakhstan
納指	纳指	Nà zhǐ	NASDAQ/National Association of Securities Dealers Automated Quotations, a computerized data system to provide brokers with price quotations for securities traded over the counter
納撒尼爾·霍桑	纳撒尼尔·霍桑	Nà sā ní ěr · Huò sāng	Nathaniel Hawthorne (1804-1864) American novelist and short story writer
納斯達克	纳斯达克	Nà sī dá kè	NASDAQ (stock exchange)
納新	纳新	nà xīn	to accept the new/to take fresh (air)/fig. to accept new members (to reinvigorate the party)/new blood
納星	纳星	nà xīng	nanosatellite
納木錯	纳木错	Nà mù cuò	Namtso or Lake Nam (officially Nam Co), mountain lake at Nakchu in central Tibet
納涼	纳凉	nà liáng	to enjoy the cool air
納溪	纳溪	Nà xī	Naxi district of Luzhou city 瀘州市|泸州市[Lú zhōu shì], Sichuan
納溪區	纳溪区	Nà xī qū	Naxi district of Luzhou city 瀘州市|泸州市[Lú zhōu shì], Sichuan
納爾遜	纳尔逊	Nà ěr xùn	Horatio Nelson (1758-1805), British naval hero
納瓦特爾語	纳瓦特尔语	Nà wǎ tè ěr yǔ	Nahuatl (language)
納瓦薩	纳瓦萨	Nà wǎ sà	Navassa
納皮爾	纳皮尔	Nà pí ěr	Napier (name)/John Napier (1550-1617), Scottish mathematician, inventor of logarithms/Napier, city in New Zealand
納福	纳福	nà fú	to accept a life of ease/to enjoy a comfortable retirement
納秒	纳秒	nà miǎo	nanosecond, ns, 10^-9 s (PRC)/Taiwan equivalent: 奈秒[nài miǎo]
納稅	纳税	nà shuì	to pay taxes
納稅人	纳税人	nà shuì rén	taxpayer
納米	纳米	nà mǐ	nanometer
納米技術	纳米技术	nà mǐ jì shù	nanotechnology
納米比亞	纳米比亚	Nà mǐ bǐ yà	Namibia
納粹	纳粹	Nà cuì	Nazi (loanword)
納粹主義	纳粹主义	Nà cuì zhǔ yì	Nazism
納粹份子	纳粹分子	Nà cuì fèn zǐ	Nazi
納粹德國	纳粹德国	Nà cuì Dé guó	Nazi Germany (1933-1945)
納粹黨	纳粹党	Nà cuì dǎng	Nazi Party/Nationalsozialistische Deutsche Arbeiterpartei (NSDAP) (1919-1945)
納糧	纳粮	nà liáng	to pay taxes in kind (rice, cloth etc)
納罕	纳罕	nà hǎn	bewildered/amazed
納聘	纳聘	nà pìn	to pay bride-price (payment to the bride's family in former times)
納蘭性德	纳兰性德	Nà lán Xìng dé	Nalan Xingde (1655-1685), Manchu ethnic Qing dynasty poet
納衛星	纳卫星	nà wèi xīng	nanosatellite
納西	纳西	Nà xī	Nakhi (ethnic group)
納西族	纳西族	Nà xī zú	Nakhi ethnic group in Yunnan
納豆	纳豆	nà dòu	nattō, a type of fermented soybean, popular as a breakfast food in Japan
納豆菌	纳豆菌	nà dòu jūn	Bacillus subtilis (formerly Bacillus natto), a common soil bacterium
納貢	纳贡	nà gòng	to pay tribute
納賄	纳贿	nà huì	bribery/to give or accept bribes
納賽爾	纳赛尔	Nà sài ěr	Nasr or Nasser (Arab name)/Gamal Abdel Nasser (1918-1970), Egyptian President
納赫雄	纳赫雄	Nà hè xióng	Nahshon (name)
納達爾	纳达尔	Nà dá ěr	Nadal (name)/Rafael Nadal (1986-), Spanish tennis player
納閩	纳闽	Nà mǐn	Labuan, island territory of Malaysia off Sabah coast, north Borneo 婆羅洲|婆罗洲
納降	纳降	nà xiáng	to surrender/to accept defeat
納雍	纳雍	Nà yōng	Nayong county in Bijie prefecture 畢節地區|毕节地区[Bì jié dì qū], Guizhou
納雍縣	纳雍县	Nà yōng xiàn	Nayong county in Bijie prefecture 畢節地區|毕节地区[Bì jié dì qū], Guizhou
納霍德卡	纳霍德卡	Nà huò dé kǎ	Nakhodka (city in Russia)
納骨塔	纳骨塔	nà gǔ tǎ	columbarium
納鴻	纳鸿	Nà hóng	Nahum
索傑納	索杰纳	Suǒ jié nà	Sojourner (Martian land rover)
結納	结纳	jié nà	to make friends/to form friendship
維也納	维也纳	Wéi yě nà	Vienna, capital of Austria
維納斯	维纳斯	Wéi nà sī	Venus (mythology, Roman goddess of love)
維羅納	维罗纳	Wéi luó nà	Verona
繳納	缴纳	jiǎo nà	to pay (taxes etc)
羅威納犬	罗威纳犬	luó wēi nà quǎn	Rottweiler (dog breed)
羅納	罗纳	Luó nà	Rhone, river of Switzerland and France
羅納河	罗纳河	Luó nà Hé	Rhone, river of Switzerland and France
羅納爾多	罗纳尔多	Luó nà ěr duō	Ronaldo (name)/Cristiano Ronaldo (1985-), Portuguese soccer player
聖文森和格林納丁	圣文森和格林纳丁	Shèng Wén sēn hé Gé lín nà dīng	St Vincent and Grenadines, Caribbean island in Lesser Antilles
聖文森特和格林納丁斯	圣文森特和格林纳丁斯	Shèng wén sēn tè hé Gé lín nà dīng sī	Saint Vincent and the Grenadines
聖納帕	圣纳帕	Shèng nà pà	Agia Napa, Cyprus/Ayia Napa, Cyprus
聲納	声纳	shēng nà	sonar (sound navigation and ranging) (loanword)
肖伯納	肖伯纳	Xiāo Bó nà	Bernard Shaw (1856-1950), Irish-born British playwright
胂凡納明	胂凡纳明	shèn fán nà míng	arsphenamine
艾納香	艾纳香	ài nà xiāng	sambong (Blumea balsamifera)
華納兄弟	华纳兄弟	Huà nà xiōng dì	Warner Brothers
華納音樂集團	华纳音乐集团	Huà nà Yīn yuè Jí tuán	Warner Music Group
萊昂納多	莱昂纳多	Lái áng nà duō	Leonardo (name)
蒙帕納斯	蒙帕纳斯	Měng pà nà sī	Montparnasse (southeast Paris, 14ème arrondissement)
蓋特納	盖特纳	Gài tè nà	Geithner (name)/Timothy Geithner (1961-), US banker, Treasury Secretary from 2009
蕭伯納	萧伯纳	Xiāo bó nà	George Bernard Shaw (1856-1950), Irish dramatist and writer
藏垢納污	藏垢纳污	cáng gòu nà wū	to hide dirt, to conceal corruption (idiom); to shelter evil people and accept wrongdoing/aiding and abetting wicked deeds
藏污納垢	藏污纳垢	cáng wū nà gòu	to hide dirt, to conceal corruption (idiom); to shelter evil people and accept wrongdoing/aiding and abetting wicked deeds
西雙版納	西双版纳	Xī shuāng bǎn nà	Xishuangbanna Dai Autonomous Prefecture in southern Yunnan
西雙版納傣族自治州	西双版纳傣族自治州	Xī shuāng bǎn nà Dǎi zú Zì zhì zhōu	Xishuangbanna Dai Autonomous Prefecture in southern Yunnan 雲南|云南[Yún nán]
西雙版納州	西双版纳州	Xī shuāng bǎn nà Zhōu	Xishuangbanna Dai Autonomous Prefecture in southern Yunnan 雲南|云南[Yún nán]
西雙版納粗榧	西双版纳粗榧	xī shuāng bǎn nà cū fěi	Cephalotaxus mannii (botany)
解百納	解百纳	Jiě bǎi nà	Cabernet (grape type)
貝納通	贝纳通	Bèi nà tōng	Benetton, clothes company
費爾干納	费尔干纳	Fèi ěr gàn nà	the Ferghana valley (in Uzbekistan, central Asia)
費爾幹納盆地	费尔干纳盆地	Fèi ěr gàn nà Pén dì	the Ferghana Valley in modern Uzbekistan
赫塞哥維納	赫塞哥维纳	Hè sè gē wéi nà	Herzegovina (Tw)
路易斯·伊納西奧·盧拉·達席爾瓦	路易斯·伊纳西奥·卢拉·达席尔瓦	Lù yì sī · Yī nà xī ào · Lú lā · Dá xí ěr wǎ	Luiz Inácio Lula da Silva, the thirty-fifth president of Brazil/Lula
迦納	迦纳	Jiā nà	Ghana (Tw)
里賈納	里贾纳	Lǐ jiǎ nà	Regina city, capital of Saskatchewan province, Canada
金雞納	金鸡纳	jīn jī nà	quinine (Cinchona ledgeriana)
金雞納樹	金鸡纳树	jīn jī nà shù	Cinchona ledgeriana/the quinine tree
金雞納霜	金鸡纳霜	jīn jī nà shuāng	quinine powder
關塔納摩	关塔纳摩	Guān tǎ nà mó	Guantanamo, Cuba
阿奎納	阿奎纳	Ā kuí nà	surname Aquinas/Thomas Aquinas 托馬斯·阿奎納|托马斯·阿奎纳[Tuō mǎ sī · Ā kuí nà] (1225-1274)
阿斯塔納	阿斯塔纳	Ā sī tǎ nà	Astana, capital of Kazakhstan
阿森納	阿森纳	Ā sēn nà	Arsenal Football Club
阿米納達布	阿米纳达布	Ā mǐ nà dá bù	Amminadab (name)
阿魯納恰爾邦	阿鲁纳恰尔邦	Ā lǔ nà qià ěr bāng	Arunachal Pradesh, a state of India in the northeast of the country, occupying an area claimed by China in an ongoing sovereignty dispute
陳納德	陈纳德	Chén nà dé	(Claire) Chennault, commander of Flying Tigers during World War II
集納	集纳	jí nà	to collect/to gather together
雷日納	雷日纳	Léi rì nà	Regina (name)/Regina, city in Brazil
韋格納	韦格纳	Wéi gé nà	Alfred Wegener (1880-1930), German meteorologist and geophysicist, the originator of the theory of continental drift/also written 魏格納|魏格纳
額濟納	额济纳	É jì nà	Ejin Banner in Alxa League 阿拉善盟[Ā lā shàn Méng], Inner Mongolia (formerly in Gansu 1969-1979)
額濟納地區	额济纳地区	É jì nà Dì qū	Ejin Banner in Alxa League 阿拉善盟[Ā lā shàn Méng], Inner Mongolia (formerly in Gansu 1969-1979)
額濟納旗	额济纳旗	É jì nà Qí	Ejin Banner in Alxa League 阿拉善盟[Ā lā shàn Méng], Inner Mongolia (formerly in Gansu 1969-1979)
額濟納河	额济纳河	É jì nà Hé	Ejin River in Alxa League 阿拉善盟[Ā lā shàn Méng], Inner Mongolia
額爾古納	额尔古纳	É ěr gǔ nà	Ergun county level city, Mongolian Ergüne xot, in Hulunbuir 呼倫貝爾|呼伦贝尔[Hū lún bèi ěr], Inner Mongolia
額爾古納右旗	额尔古纳右旗	É ěr gǔ nà yòu qí	former Ergun Right banner, now in Ergun county level city, Mongolian Ergüne xot, in Hulunbuir 呼倫貝爾|呼伦贝尔[Hū lún bèi ěr], Inner Mongolia
額爾古納左旗	额尔古纳左旗	É ěr gǔ nà zuǒ qí	former Ergun Left banner, now in Ergun county level city, Mongolian Ergüne xot, in Hulunbuir 呼倫貝爾|呼伦贝尔[Hū lún bèi ěr], Inner Mongolia
額爾古納市	额尔古纳市	É ěr gǔ nà shì	Ergun county level city, Mongolian Ergüne xot, in Hulunbuir 呼倫貝爾|呼伦贝尔[Hū lún bèi ěr], Inner Mongolia
額爾古納河	额尔古纳河	É ěr gǔ nà Hé	Argun River of Mongolia and Heilongjiang province, tributary of Heilongjiang River 黑龍江|黑龙江[Hēi lóng jiāng]
馬利亞納海溝	马利亚纳海沟	Mǎ lì yà nà hǎi gōu	Mariana Trench (or Marianas Trench)
馬利亞納群島	马利亚纳群岛	Mǎ lì yà nà Qún dǎo	Mariana Islands in the Pacific
馬拉多納	马拉多纳	Mǎ lā duō nà	Diego Maradona (1960-), Argentine footballer
馬爾維納斯群島	马尔维纳斯群岛	Mǎ ěr wéi nà sī Qún dǎo	Malvinas Islands (also known as Falkland Islands)
馬納馬	马纳马	Mǎ nà mǎ	Manama, capital of Bahrain
馬里亞納海溝	马里亚纳海沟	Mǎ lǐ yà nà Hǎi gōu	Mariana Trench (or Marianas Trench)
馬里亞納群島	马里亚纳群岛	Mǎ lǐ yà nà Qún dǎo	Mariana Islands in the Pacific
高德納	高德纳	Gāo Dé nà	the Chinese name of American computer scientist Donald Knuth (1938-), adopted prior to his visit to China in 1977
魏格納	魏格纳	Wèi gé nà	Alfred Wegener (1880-1930), German meteorologist and geophysicist, the originator of the theory of continental drift
麗江納西族自治縣	丽江纳西族自治县	Lì jiāng Nà xī zú Zì zhì xiàn	Lijiang Naxi Autonomous County in Yunnan
麥納瑪	麦纳玛	Mài nà mǎ	Manama, capital of Bahrain (Tw)
麥納麥	麦纳麦	Mài nà mài	Manama, capital city of Bahrain
