均	均	jūn	equal/even/all/uniform
不患寡而患不均	不患寡而患不均	bù huàn guǎ ér huàn bù jūn	do not worry about scarcity, but rather about uneven distribution (idiom, from Analects)
人均	人均	rén jūn	per capita
力量均衡	力量均衡	lì liàng jūn héng	balance of power
加權平均	加权平均	jiā quán píng jūn	weighted average
勢均力敵	势均力敌	shì jūn lì dí	evenly matched (idiom)
十二平均律	十二平均律	shí èr píng jūn lǜ	equal temperament
不均	不均	bù jūn	uneven/distributed unevenly
均一	均一	jūn yī	even/uniform/homogeneous
均值	均值	jūn zhí	average value
均分	均分	jūn fēn	to split/to divide equally
均勢	均势	jūn shì	equilibrium of forces/balance of power
均勻	均匀	jūn yún	even/well-distributed/homogeneous/well-proportioned (figure, body etc)
均勻性	均匀性	jūn yún xìng	homogeneity/uniformity
均可	均可	jūn kě	all are OK/both are OK/all can/both can/also can
均差	均差	jūn chā	divided differences (numerical analysis)/mean absolute difference (statistics)
均攤	均摊	jūn tān	to share equally/to distribute evenly
均方	均方	jūn fāng	mean square
均日照	均日照	jūn rì zhào	average annual sunshine
均沾	均沾	jūn zhān	to share (profits)
均濕	均湿	jūn shī	to moisten evenly (e.g. in tanning leather)
均熱	均热	jūn rè	to heat evenly (e.g. in smelting metal)
均田制	均田制	jūn tián zhì	equal-field system of Wei of the Northern dynasties 北魏 and Tang 唐 dynasties
均等	均等	jūn děng	equal/impartial/fair
均等化	均等化	jūn děng huà	to equalize/leveling/making uniform
均等論	均等论	jūn děng lùn	doctrine of equivalents (patent law)
均線	均线	jūn xiàn	graph of average values
均線指標	均线指标	jūn xiàn zhǐ biāo	moving average index (used in financial analysis)
均腐土	均腐土	Jūn fǔ tǔ	Isohumosols (Chinese Soil Taxonomy)
均衡	均衡	jūn héng	equal/balanced/harmony/equilibrium
均衡器	均衡器	jūn héng qì	equalizer (electronics, audio)
均變論	均变论	jūn biàn lùn	uniformitarianism
均質	均质	jūn zhì	homogenous/uniform/homogenized
平均	平均	píng jūn	average/on average/evenly/in equal proportions
平均主義	平均主义	píng jūn zhǔ yì	egalitarianism
平均值	平均值	píng jūn zhí	average value
平均值定理	平均值定理	píng jūn zhí dìng lǐ	the mean value theorem (in calculus)
平均劑量	平均剂量	píng jūn jì liàng	average dose
平均壽命	平均寿命	píng jūn shòu mìng	life expectancy
平均差	平均差	píng jūn chā	mean deviation (math.)
平均律	平均律	píng jūn lǜ	equal temperament (music)
平均收入	平均收入	píng jūn shōu rù	average income
平均數	平均数	píng jūn shù	mean (statistics)
平方平均數	平方平均数	píng fāng píng jūn shù	root mean square (RMS)/quadratic root
年均	年均	nián jūn	annual average (rate)
年均增長率	年均增长率	nián jūn zēng zhǎng lǜ	annual rate of growth
年均日照	年均日照	nián jūn rì zhào	average annual sunshine
幾何平均數	几何平均数	jǐ hé píng jūn shù	geometric mean
成均館	成均馆	Chéng jūn guǎn	Koryo Seonggyungwan, university dating back to Korean Goryeo dynasty, in Gaesong, North Korea/Sungkyun kwan university, Seoul
戶均	户均	hù jūn	household average
日經平均	日经平均	Rì jīng píng jūn	Nikkei 225 stock market index
日經平均指數	日经平均指数	Rì jīng píng jūn zhǐ shù	Nikkei 225 stock market index
日經平均指數	日经平均指数	rì jīng píng jūn zhǐ shù	Nikkei index
核均勢	核均势	hé jūn shì	nuclear parity
移動平均線	移动平均线	yí dòng píng jūn xiàn	moving average (in financial analysis)
移動平均線指標	移动平均线指标	yí dòng píng jūn xiàn zhǐ biāo	moving average index (used in financial analysis)
算術平均	算术平均	suàn shù píng jūn	arithmetic mean (math.)
算術平均數	算术平均数	suàn shù píng jūn shù	arithmetic mean
調和平均數	调和平均数	tiáo hé píng jūn shù	harmonic mean
陸均松	陆均松	lù jūn sōng	podocarp tree (Dacrydium pierrei)
非均質	非均质	fēi jūn zhì	inhomogeneous
