妖	妖	yāo	goblin/witch/devil/bewitching/enchanting/monster/phantom/demon
口袋妖怪	口袋妖怪	Kǒu dài Yāo guài	Pokémon (Japanese media franchise)
人妖	人妖	rén yāo	transvestite/transsexual/ladyboy
妖人	妖人	yāo rén	magician/sorcerer
妖冶	妖冶	yāo yě	pretty and flirtatious
妖女	妖女	yāo nǚ	beautiful woman
妖姬	妖姬	yāo jī	(literary) beauty (usually of a maid or concubine)
妖婦	妖妇	yāo fù	witch (esp. European)
妖媚	妖媚	yāo mèi	seductive
妖嬈	妖娆	yāo ráo	enchanting/alluring (of a girl)
妖孽	妖孽	yāo niè	evildoer
妖怪	妖怪	yāo guài	monster/devil
妖氣	妖气	yāo qì	sinister appearance/monster-like appearance
妖物	妖物	yāo wù	monster
妖精	妖精	yāo jing	evil spirit/alluring woman
妖艷	妖艳	yāo yàn	pretty and flirtatious
妖術	妖术	yāo shù	sorcery
妖術師	妖术师	yāo shù shī	warlock/sorcerer
妖言	妖言	yāo yán	heresy
妖言惑眾	妖言惑众	yāo yán huò zhòng	to mislead the public with rumors (idiom)/to delude the people with lies
妖邪	妖邪	yāo xié	evil monster
妖風	妖风	yāo fēng	evil wind
妖魔	妖魔	yāo mó	demon
妖魔鬼怪	妖魔鬼怪	yāo mó guǐ guài	demons and ghosts/ghouls and bogies
小妖	小妖	xiǎo yāo	small demon
小妖精	小妖精	xiǎo yāo jīng	goblin/hussy/floozy
屠妖節	屠妖节	Tú yāo jié	Deepavali (Hindu festival)
照妖鏡	照妖镜	zhào yāo jìng	magic mirror for revealing goblins/fig. way of seeing through a conspiracy
興妖作怪	兴妖作怪	xīng yāo zuò guài	lit. to summon demons to create havoc (idiom)/fig. to stir up all kinds of trouble
藍色妖姬	蓝色妖姬	lán sè yāo jī	blue rose
鎮妖	镇妖	zhèn yāo	to drive away evil spirits
降妖	降妖	xiáng yāo	to subdue monsters
