墊	垫	diàn	pad/cushion/mat/to pad out/to fill a gap/to pay for sb/to advance (money)
坐墊	坐垫	zuò diàn	cushion/(motorbike) seat/CL:塊|块[kuài]
坐廁墊	坐厕垫	zuò cè diàn	toilet seat
卡墊	卡垫	kǎ diàn	(Tibetan) rug/mat
墊上	垫上	diàn shàng	to pay for sb
墊付	垫付	diàn fù	to pay sb else's expense with the expectation of being reimbursed by that person later
墊圈	垫圈	diàn juàn	to spread litter in a cowshed, pigsty etc
墊圈	垫圈	diàn quān	washer (on bolt)/toilet seat
墊子	垫子	diàn zi	cushion/mat/pad
墊平	垫平	diàn píng	to level (surfaces)
墊底兒	垫底儿	diàn dǐ r5	foundation layer/underlay/fig. to lay foundations/to snack
墊底費	垫底费	diàn dǐ fèi	(finance) deductible/excess fee
墊支	垫支	diàn zhī	to advance funds
墊料	垫料	diàn liào	packing material/lagging/litter
墊檔	垫档	diàn dàng	to fill a blank space/to fill a slot (in a newspaper column, a TV program etc)
墊款	垫款	diàn kuǎn	advance (of funds)
墊江	垫江	Diàn jiāng	Dianjiang county in Fuling suburbs of Chongqing municipality, formerly in Sichuan
墊江縣	垫江县	Diàn jiāng xiàn	Dianjiang county in Fuling suburbs of Chongqing municipality, formerly in Sichuan
墊片	垫片	diàn piàn	spacer/shim
墊肩	垫肩	diàn jiān	shoulder pad
墊背	垫背	diàn bèi	to serve as a sacrificial victim/to suffer for sb else/scapegoat/to share sb's fate
墊腳	垫脚	diàn jiao	litter (animal bedding)
墊腳石	垫脚石	diàn jiǎo shí	stepping stone/fig. person used to advance one's career
墊被	垫被	diàn bèi	mattress
墊補	垫补	diàn bu	(coll.) to cover a shortfall by using funds intended for another purpose or by borrowing some money/(coll.) to snack
墊褥	垫褥	diàn rù	cotton-padded mattress
墊高	垫高	diàn gāo	a support/to raise/to bolster/to jack up
床墊	床垫	chuáng diàn	mattress/CL:張|张[zhāng]
彈簧墊圈	弹簧垫圈	tán huáng diàn quān	spring washer
擦鞋墊	擦鞋垫	cā xié diàn	doormat
月經墊	月经垫	yuè jīng diàn	sanitary towel/menopad
杯墊	杯垫	bēi diàn	(beverage) coaster
棕墊	棕垫	zōng diàn	palm fiber mat
止血墊	止血垫	zhǐ xuè diàn	dressing/pad to stop bleeding
氣墊	气垫	qì diàn	air cushion (as on hovercraft)
氣墊船	气垫船	qì diàn chuán	hovercraft/air cushion vehicle
滑鼠墊	滑鼠垫	huá shǔ diàn	mouse pad (Tw)
肉墊	肉垫	ròu diàn	pad (on animal paw)
草墊	草垫	cǎo diàn	straw mattress
草墊子	草垫子	cǎo diàn zi	straw mattress/palliasse
襯墊	衬垫	chèn diàn	pad
踏墊	踏垫	tà diàn	floor mat/bathroom mat/car mat/doormat
野餐墊	野餐垫	yě cān diàn	picnic blanket
鋪墊	铺垫	pū diàn	to spread out bedding/bedcover
鍋墊	锅垫	guō diàn	trivet/pot-holder
門墊	门垫	mén diàn	doormat
防潮墊	防潮垫	fáng cháo diàn	groundsheet (for camping etc)
鞋墊	鞋垫	xié diàn	insole/shoe insert
鼠標墊	鼠标垫	shǔ biāo diàn	mouse pad
