膽	胆	dǎn	gall bladder/courage/guts/gall/inner container (e.g. bladder of a football, inner container of a thermos)
乙酰膽鹼	乙酰胆碱	yǐ xiān dǎn jiǎn	acetylcholine ACh (amine related to vitamin B complex)
傾心吐膽	倾心吐胆	qīng xīn tǔ dǎn	to pour out one's heart (idiom)
剖肝瀝膽	剖肝沥胆	pōu gān lì dǎn	to be completely honest and sincere (idiom)
吃熊心豹子膽	吃熊心豹子胆	chī xióng xīn bào zi dǎn	to eat bear heart and leopard gall (idiom)/to pluck up some courage
喪膽	丧胆	sàng dǎn	panic-stricken/scared out of one's wits
嚇破膽	吓破胆	xià pò dǎn	to be scared out of one's wits/to scare stiff
壯起膽子	壮起胆子	zhuàng qǐ dǎn zi	to proceed with sth even though scared/to put on a brave face
大膽	大胆	dà dǎn	brazen/audacious/outrageous/bold/daring/fearless
孤膽	孤胆	gū dǎn	solitary hero/maverick
孤膽英雄	孤胆英雄	gū dǎn yīng xióng	solitary hero/maverick
心膽	心胆	xīn dǎn	courage
心膽俱裂	心胆俱裂	xīn dǎn jù liè	to be scared out of one's wits (idiom)
心驚膽戰	心惊胆战	xīn jīng dǎn zhàn	lit. heart alarmed, trembling in fear (idiom); prostrate with fear/scared witless
心驚膽顫	心惊胆颤	xīn jīng dǎn chàn	see 心驚膽戰|心惊胆战[xīn jīng dǎn zhàn]
披肝瀝膽	披肝沥胆	pī gān lì dǎn	lit. to open one's liver and drip gall (idiom); wholehearted loyalty
提心吊膽	提心吊胆	tí xīn diào dǎn	(saying) to be very scared and on edge
撐死膽大的，餓死膽小的	撑死胆大的，饿死胆小的	chēng sǐ dǎn dà de , è sǐ dǎn xiǎo de	fullness for the bold, famine for the timid (idiom)
放膽	放胆	fàng dǎn	to act boldly
斗膽	斗胆	dǒu dǎn	(courteous) to be so bold as to
明目張膽	明目张胆	míng mù zhāng dǎn	openly and without fear/brazenly
有膽量	有胆量	yǒu dǎn liàng	courageous
有色無膽	有色无胆	yǒu sè wú dǎn	to be perverse and suggestive towards the opposite sex, but shrinking back when provoked to act on it/to have perverted thoughts but no guts to actually do it/to be all talk and no action
海膽	海胆	hǎi dǎn	sea urchin
熊膽	熊胆	xióng dǎn	bear gall (used in TCM)
熊膽草	熊胆草	xióng dǎn cǎo	Conyza blinii
狗膽包天	狗胆包天	gǒu dǎn bāo tiān	extremely daring (idiom)/foolhardy
獨膽	独胆	dú dǎn	individually courageous
獨膽英雄	独胆英雄	dú dǎn yīng xióng	bold and courageous hero (idiom)
破膽	破胆	pò dǎn	to be scared stiff
破膽寒心	破胆寒心	pò dǎn hán xīn	to be scared out of one's wits
碎心裂膽	碎心裂胆	suì xīn liè dǎn	in mortal fear (idiom)
聞風喪膽	闻风丧胆	wén fēng sàng dǎn	hear the wind and lose gall (idiom); terror-stricken at the news
肝膽相照	肝胆相照	gān dǎn xiāng zhào	to treat one another with absolute sincerity (idiom); to show total devotion
一身是膽	一身是胆	yī shēn shì dǎn	devoid of fear (idiom)/intrepid
膽兒	胆儿	dǎn r5	see 膽子|胆子[dǎn zi]
膽力	胆力	dǎn lì	courage/bravery
膽囊	胆囊	dǎn náng	gall bladder
膽固醇	胆固醇	dǎn gù chún	cholesterol
膽大	胆大	dǎn dà	daring/bold/audacious
膽大包天	胆大包天	dǎn dà bāo tiān	reckless/extremely daring
膽大妄為	胆大妄为	dǎn dà wàng wéi	daring/presumptuous/daredevil
膽子	胆子	dǎn zi	courage/nerve/guts
膽寒	胆寒	dǎn hán	to fear/to be terrified
膽小	胆小	dǎn xiǎo	cowardice/timid
膽小如鼠	胆小如鼠	dǎn xiǎo rú shǔ	chicken-hearted (idiom)/gutless
膽小鬼	胆小鬼	dǎn xiǎo guǐ	coward
膽怯	胆怯	dǎn qiè	timidity/timid/cowardly
膽戰	胆战	dǎn zhàn	to tremble with fear
膽戰心驚	胆战心惊	dǎn zhàn xīn jīng	to tremble with fear (idiom)/scared witless
膽敢	胆敢	dǎn gǎn	to dare (negative connotation)/to have the audacity to (do sth)
膽氣	胆气	dǎn qì	courageous/bold
膽汁	胆汁	dǎn zhī	gall/bile
膽略	胆略	dǎn lüè	courage and resource
膽石	胆石	dǎn shí	gallstone
膽石症	胆石症	dǎn shí zhèng	gallstone
膽石絞痛	胆石绞痛	dǎn shí jiǎo tòng	gallstone colic
膽破	胆破	dǎn pò	to be frightened to death
膽管	胆管	dǎn guǎn	bile duct
膽紅素	胆红素	dǎn hóng sù	bilirubin
膽結石	胆结石	dǎn jié shí	gallstone
膽綠素	胆绿素	dǎn lǜ sù	biliverdin
膽色素	胆色素	dǎn sè sù	bilirubin
膽識	胆识	dǎn shí	courage and insight
膽道	胆道	dǎn dào	bile duct/biliary tract
膽量	胆量	dǎn liàng	courage/boldness/guts
膽顫心驚	胆颤心惊	dǎn chàn xīn jīng	panic-stricken
膽驚心顫	胆惊心颤	dǎn jīng xīn chàn	see 心驚膽戰|心惊胆战[xīn jīng dǎn zhàn]
膽魄	胆魄	dǎn pò	courage/bravery
膽鹼	胆碱	dǎn jiǎn	choline (amine related to vitamin B complex)
膽鹼酯酶	胆碱酯酶	dǎn jiǎn zhǐ méi	choline esterase (ChE), hydrolyzing enzyme in blood plasma
臥薪嘗膽	卧薪尝胆	wò xīn cháng dǎn	lit. to sleep on brushwood and taste gall (like King Gou Jian of Yue 勾踐|勾践[Gōu Jiàn]), in order to recall one's humiliations) (idiom)/fig. to maintain one's resolve for revenge
臥薪嚐膽	卧薪尝胆	wò xīn cháng dǎn	lit. to lie on firewood and taste gall (idiom); fig. suffering patiently, but firmly resolved on revenge
色膽	色胆	sè dǎn	boldness in pursuing one's sexual urges
色膽包天	色胆包天	sè dǎn bāo tiān	outrageously bold in one's lust/debauched (idiom)
苦膽	苦胆	kǔ dǎn	gall bladder
蛇膽	蛇胆	shé dǎn	snake gall (used in TCM)
赤膽忠心	赤胆忠心	chì dǎn zhōng xīn	lit. red-bellied devotion (idiom); wholehearted loyalty/to serve sb with body and soul
驚心膽顫	惊心胆颤	jīng xīn dǎn chàn	frightening/frightened (idiom)
鼠膽	鼠胆	shǔ dǎn	cowardly
龍肝鳳膽	龙肝凤胆	lóng gān fèng dǎn	rare food/ambrosia (delicacy)
龍膽	龙胆	lóng dǎn	rough gentian/Japanese gentian (Gentiana scabra)
龍膽紫	龙胆紫	lóng dǎn zǐ	gentian violet C25H30ClN3/crystal violet
