堆	堆	duī	to pile up/to heap up/a mass/pile/heap/stack/large amount
乃堆拉	乃堆拉	Nǎi duī lā	Nathu La (Himalayan pass on Silk Road between Tibet and Indian Sikkim)
乃堆拉山口	乃堆拉山口	Nǎi duī lā shān kǒu	Nathu La (Himalayan pass on Silk Road between Tibet and Indian Sikkim)
估堆兒	估堆儿	gū duī r5	to assess an entire lot
六方最密堆積	六方最密堆积	liù fāng zuì mì duī jī	hexagonal close-packed (HCP) (math.)
動力反應堆	动力反应堆	dòng lì fǎn yìng duī	power reactor
原子反應堆	原子反应堆	yuán zǐ fǎn yìng duī	atomic reactor
原子堆	原子堆	yuán zǐ duī	atomic pile (original form of nuclear reactor)
反應堆	反应堆	fǎn yìng duī	reactor
反應堆燃料元件	反应堆燃料元件	fǎn yìng duī rán liào yuán jiàn	fuel element
反應堆芯	反应堆芯	fǎn yìng duī xīn	reactor core
土堆	土堆	tǔ duī	mound
垃圾堆	垃圾堆	lā jī duī	garbage heap
一堆	一堆	yī duī	pile
堆壘	堆垒	duī lěi	to pile up/accumulative
堆壘數論	堆垒数论	duī lěi shù lùn	additive number theory (math.)
堆放	堆放	duī fàng	to pile up/to stack
堆案盈几	堆案盈几	duī àn yíng jī	lit. piles of work and papers (idiom); fig. accumulated backlog of work
堆棧	堆栈	duī zhàn	stack (computing)/storehouse/warehouse
堆滿	堆满	duī mǎn	to pile up
堆疊	堆叠	duī dié	to pile up/to put layer upon layer/(Tw) (computing) stack
堆砌	堆砌	duī qì	lit. to pile up (bricks)/to pack/fig. to pad out (writing with fancy phrases)/ornate rhetoric
堆積	堆积	duī jī	to pile up/to heap/accumulation
堆積如山	堆积如山	duī jī rú shān	to pile up like a mountain (idiom)/a mountain of (paperwork etc)/a large number of sth
堆積木	堆积木	duī jī mù	to play with stacking blocks
堆肥	堆肥	duī féi	compost
堆芯	堆芯	duī xīn	reactor core
堆金積玉	堆金积玉	duī jīn jī yù	lit. pile up gold and jade/very rich
堆高機	堆高机	duī gāo jī	forklift
堆高車	堆高车	tuī gāo chē	power pallet truck
堆龍德慶	堆龙德庆	Duī lóng dé qìng	Doilungdêqên county, Tibetan: Stod lung bde chen rdzong in Lhasa 拉薩|拉萨[Lā sà], Tibet
堆龍德慶縣	堆龙德庆县	Duī lóng dé qìng xiàn	Doilungdêqên county, Tibetan: Stod lung bde chen rdzong in Lhasa 拉薩|拉萨[Lā sà], Tibet
增殖反應堆	增殖反应堆	zēng zhí fǎn yìng duī	breeder reactor
扎堆	扎堆	zhā duī	to gather together
故紙堆	故纸堆	gù zhǐ duī	a pile of old books
料堆	料堆	liào duī	to stockpile
最密堆積	最密堆积	zuì mì duī jī	close-packing of spheres (math.)
木柴堆	木柴堆	mù chái duī	pile of firewood/funeral pyre
核反應堆	核反应堆	hé fǎn yìng duī	nuclear reactor
核試驗堆	核试验堆	hé shì yàn duī	nuclear test reactor
氣冷式反應堆	气冷式反应堆	qì lěng shì fǎn yìng duī	gas-cooled reactor
火堆	火堆	huǒ duī	bonfire/to open fire
熱核反應堆	热核反应堆	rè hé fǎn yìng duī	thermal reactor
瓦礫堆	瓦砾堆	wǎ lì duī	pile of rubble/debris
生產反應堆	生产反应堆	shēng chǎn fǎn yìng duī	production reactor
石墨氣冷堆	石墨气冷堆	shí mò qì lěng duī	gas-graphite reactor
研究反應堆	研究反应堆	yán jiū fǎn yìng duī	research reactor
紙堆	纸堆	zhǐ duī	papers/stack of paper
輕水反應堆	轻水反应堆	qīng shuǐ fǎn yìng duī	light water reactor (LWR)
重水反應堆	重水反应堆	zhòng shuǐ fǎn yìng duī	heavy water reactor (HWR)
鑽故紙堆	钻故纸堆	zuān gù zhǐ duī	to dig into piles of outdated writings (idiom); to study old books and papers
零功率堆	零功率堆	líng gōng lǜ duī	zero power reactor
露天堆棧	露天堆栈	lù tiān duī zhàn	open-air repository/open-air depot
面心立方最密堆積	面心立方最密堆积	miàn xīn lì fāng zuì mì duī jī	face-centered cubic (FCC) (math.)
馬王堆	马王堆	Mǎ Wáng duī	Mawangdui in Changsha, Hunan, a recent Han dynasty archaeological site
