售	售	shòu	to sell/to make or carry out (a plan or intrigue etc)
出售	出售	chū shòu	to sell/to offer for sale/to put on the market
司售人員	司售人员	sī shòu rén yuán	bus crew/driver and conductor
兜售	兜售	dōu shòu	to hawk/to peddle
售價	售价	shòu jià	selling price
售完	售完	shòu wán	to sell out
售完即止	售完即止	shòu wán jí zhǐ	while stocks last/subject to availability
售後服務	售后服务	shòu hòu fú wù	after-sales service
售票口	售票口	shòu piào kǒu	ticket window
售票員	售票员	shòu piào yuán	ticket seller
售票大廳	售票大厅	shòu piào dà tīng	ticket office
售票處	售票处	shòu piào chù	ticket office
售罄	售罄	shòu qìng	to be completely sold out/to sell out
售貨	售货	shòu huò	to sell goods
售貨員	售货员	shòu huò yuán	salesperson/CL:個|个[gè]
售貨臺	售货台	shòu huò tái	vendor's stall
售賣	售卖	shòu mài	to sell
寄售	寄售	jì shòu	sale on consignment
建議售價	建议售价	jiàn yì shòu jià	recommended retail price (RRP)
拋售	抛售	pāo shòu	to dump (selling abroad more cheaply than cost price at home)
攤售	摊售	tān shòu	to set up stall
標售	标售	biāo shòu	to sell by tender
無人售票	无人售票	wú rén shòu piào	self-service ticketing/automated ticketing
發售	发售	fā shòu	to sell
私售	私售	sī shòu	see 私賣|私卖[sī mài]
自動售貨機	自动售货机	zì dòng shòu huò jī	vending machine
虧本出售	亏本出售	kuī běn chū shòu	to sell at a loss
製售	制售	zhì shòu	to manufacture and sell
販售	贩售	fàn shòu	to sell
超售	超售	chāo shòu	overbooking
躉售	趸售	dǔn shòu	to sell wholesale
軍售	军售	jūn shòu	arms sales
配售	配售	pèi shòu	to ration merchandise (esp. food in times of shortages)
銷售	销售	xiāo shòu	to sell/to market/sales (representative, agreement etc)
銷售時點	销售时点	xiāo shòu shí diǎn	point of sale
銷售時點情報系統	销售时点情报系统	xiāo shòu shí diǎn qíng bào xì tǒng	point of sale system
銷售額	销售额	xiāo shòu é	sales figure/total income from sales/turnover
銷售點	销售点	xiāo shòu diǎn	point of sale (POS)/checkout/retail outlet
零售	零售	líng shòu	to retail/to sell individually or in small quantities
零售商	零售商	líng shòu shāng	retailer/shopkeeper/retail merchant
零售店	零售店	líng shòu diàn	shop/retail store
預售	预售	yù shòu	advance sale/to sell in advance/to book
