適	适	Shì	surname Shi
適	适	shì	to fit/suitable/proper/just (now)/comfortable/well/to go/to follow or pursue
不適當	不适当	bù shì dàng	inadequate/unfit
削足適履	削足适履	xuē zú shì lǚ	to cut the feet to fit the shoes (idiom); to force sth to fit (as to a Procrustean bed)/impractical or inelegant solution
合適	合适	hé shì	suitable/fitting/appropriate
安適	安适	ān shì	quiet and comfortable
安閒舒適	安闲舒适	ān xián shū shì	leisurely and free (idiom)/carefree and at ease
幫寶適	帮宝适	Bāng bǎo shì	(brand) Pampers
恬適	恬适	tián shì	quiet and comfortable
普適	普适	pǔ shì	universal
暗適應	暗适应	àn shì yìng	dark adaptation
無所適從	无所适从	wú suǒ shì cóng	not knowing which course to follow (idiom); at a loss what to do
胡適	胡适	Hú Shì	Hu Shi (1891-1962), original proponent of writing in colloquial Chinese 白話文|白话文[bái huà wén]
自適應	自适应	zì shì yìng	adaptive
舒適	舒适	shū shì	cozy/snug
舒適音	舒适音	shū shì yīn	comfortable voice (well within one's range of pitch)
調適	调适	tiáo shì	to adapt (to an environment etc)/to make sth suitable/adaptation/adjustment/adaptive
不舒適	不舒适	bù shū shì	uncomfortable
不適	不适	bù shì	unwell/indisposed/out of sorts
適中	适中	shì zhōng	moderate/reasonable/conveniently situated
適人	适人	shì rén	(said of a woman) to marry (old)
適值	适值	shì zhí	just at that time/as it happens/by good luck, just then
適切	适切	shì qiè	apt/appropriate
適可而止	适可而止	shì kě ér zhǐ	to stop before going too far (idiom); to stop while one can/don't overdo it/stop while you're ahead
適合	适合	shì hé	to fit/to suit
適婚	适婚	shì hūn	of marriageable age/nubile
適婚期	适婚期	shì hūn qī	ages suitable for getting married
適存度	适存度	shì cún dù	fitness (evolution)/ability to survive and reproduce
適宜	适宜	shì yí	suitable/appropriate
適度	适度	shì dù	moderately/appropriate
適得其反	适得其反	shì dé qí fǎn	to produce the opposite of the desired result
適得其所	适得其所	shì dé qí suǒ	exactly what one would wish/to find one's niche
適意	适意	shì yì	agreeable
適應	适应	shì yìng	to adapt/to fit/to suit
適應性	适应性	shì yìng xìng	adaptability/flexibility
適才	适才	shì cái	just now/a moment ago
適時	适时	shì shí	timely/apt to the occasion/in due course
適格	适格	shì gé	to be qualified (to bring a complaint, lawsuit etc) (law)
適溫	适温	shì wēn	thermophile (e.g. bacteria)/heat-loving
適用	适用	shì yòng	to be applicable
適當	适当	shì dàng	suitable/appropriate
適者生存	适者生存	shì zhě shēng cún	survival of the fittest
適航	适航	shì háng	to be airworthy/to be seaworthy
適逢	适逢	shì féng	to just happen to coincide with
適逢其會	适逢其会	shì féng qí huì	to just happen to coincide with the occasion (idiom)/to be present just at the right time
適配	适配	shì pèi	adaptation
適配器	适配器	shì pèi qì	adapter (device)
適配層	适配层	shì pèi céng	adaptation layer
適量	适量	shì liàng	appropriate amount
適銷	适销	shì xiāo	marketable/saleable/appropriate to the market
適間	适间	shì jiān	just now/the present time
適齡	适龄	shì líng	of age/of the appropriate age
閒適	闲适	xián shì	leisurely and comfortable/relaxed
順適	顺适	shùn shì	agreeable/to conform
