道	道	dào	road/path/CL:條|条[tiáo],股[gǔ]/principle/truth/morality/reason/skill/method/Dao (of Daoism)/to say/to speak/to talk/classifier for long thin things (rivers, cracks etc), barriers (walls, doors etc), questions (in an exam etc), commands, courses in a meal, steps in a process/(old) circuit (administrative division)
一條道走到黑	一条道走到黑	yī tiáo dào zǒu dào hēi	to stick to one's ways/to cling to one's course
一語道破	一语道破	yī yǔ dào pò	one word says it all (idiom)/to hit the nail on the head/to be pithy and correct
一道	一道	yī dào	together
三道眉草鵐	三道眉草鹀	sān dào méi cǎo wú	(bird species of China) meadow bunting (Emberiza cioides)
上呼吸道感染	上呼吸道感染	shàng hū xī dào gǎn rǎn	upper respiratory tract infection
上軌道	上轨道	shàng guǐ dào	to stay on track/to proceed smoothly
下水道	下水道	xià shuǐ dào	sewer
不人道	不人道	bù rén dào	inhuman
不足為外人道	不足为外人道	bù zú wéi wài rén dào	no use to tell others/let's keep this between ourselves (idiom)
不足為道	不足为道	bù zú wéi dào	to be not worth mentioning
不足道	不足道	bù zú dào	inconsiderable/of no consequence/not worth mentioning
不道德	不道德	bù dào dé	immoral
世道	世道	shì dào	the ways of the world/the morals of the time
中庸之道	中庸之道	zhōng yōng zhī dào	doctrine of the mean/moderation in all things
主航道	主航道	zhǔ háng dào	main channel
亂道	乱道	luàn dào	see 亂說|乱说[luàn shuō]
二道	二道	Èr dào	Erdao district of Changchun city 長春市|长春市, Jilin
二道區	二道区	Èr dào qū	Erdao district of Changchun city 長春市|长春市, Jilin
二道江	二道江	Èr dào jiāng	Erdaojiang district of Tonghua city 通化市, Jilin
二道江區	二道江区	Èr dào jiāng qū	Erdaojiang district of Tonghua city 通化市, Jilin
二道販子	二道贩子	èr dào fàn zi	middleman/buyer and seller
五斗米道	五斗米道	Wǔ dǒu mǐ Dào	Way of the Five Pecks of Rice (Taoist movement)/Way of the Celestial Master
五道口	五道口	Wǔ dào kǒu	Wudaokou neighborhood of Beijing
交流道	交流道	jiāo liú dào	(Tw) highway interchange/(fig.) channel of communication
京畿道	京畿道	Jīng jī dào	Gyeonggi Province, South Korea, surrounding Seoul and Incheon, capital Suweon City 水原市[Shuǐ yuán shì]
人行地下通道	人行地下通道	rén xíng dì xià tōng dào	pedestrian underpass
人行橫道	人行横道	rén xíng héng dào	pedestrian crossing
人行橫道線	人行横道线	rén xíng héng dào xiàn	crosswalk/pedestrian crossing with zebra stripes
人行道	人行道	rén xíng dào	sidewalk
人道	人道	rén dào	human sympathy/humanitarianism/humane/the "human way", one of the stages in the cycle of reincarnation (Buddhism)/sexual intercourse
人道主義	人道主义	rén dào zhǔ yì	humanism/humanitarian (aid)
人道救援	人道救援	rén dào jiù yuán	humanitarian aid
仁義道德	仁义道德	rén yì dào dé	compassion, duty, propriety and integrity (idiom); all the traditional virtues/mainly used sarcastically, to mean hypocritical
以其人之道，還治其人之身	以其人之道，还治其人之身	yǐ qí rén zhī dào , huán zhì qí rén zhī shēn	to use an opponent's own methods to obtain retribution (idiom, from Song dynasty neo-Confucianist Zhu Xi 朱熹); to get revenge by playing sb back at his own game/to give sb a taste of his own medicine
任重道遠	任重道远	rèn zhòng dào yuǎn	a heavy load and a long road/fig. to bear heavy responsibilities through a long struggle (cf Confucian Analects, 8.7)
佈道	布道	bù dào	sermon/to sermonize/to preach/to evangelize
低地軌道	低地轨道	dī dì guǐ dào	see 近地軌道|近地轨道[jìn dì guǐ dào]
你走你的陽關道，我過我的獨木橋	你走你的阳关道，我过我的独木桥	nǐ zǒu nǐ de Yáng guān Dào , wǒ guò wǒ de dú mù qiáo	lit. you hit the high road, I'll cross the log bridge (idiom)/fig. you go your way, I'll go mine/you do it your way, I'll do it mine
便道	便道	biàn dào	pavement/sidewalk/shortcut/makeshift road
信道	信道	xìn dào	signal path
修道	修道	xiū dào	to practice Daoism
修道士	修道士	xiū dào shì	friar/frater
修道會	修道会	xiū dào huì	order (of monks)
修道院	修道院	xiū dào yuàn	monastery/convent
假道	假道	jiǎ dào	via/by way of
假道伐虢	假道伐虢	jiǎ dào fá Guó	to obtain safe passage to conquer the State of Guo/to borrow the resources of an ally to attack a common enemy (idiom)
傳輸通道	传输通道	chuán shū tōng dào	transport channel
傳道	传道	chuán dào	to lecture on doctrine/to expound the wisdom of ancient sages/to preach/a sermon
傳道受業	传道受业	chuán dào shòu yè	to teach (idiom); lit. to give moral and practical instruction
傳道書	传道书	Chuán dào Shū	Ecclesiastes (biblical book of sermons)
傳道者	传道者	chuán dào zhě	missionary/preacher
傳道部	传道部	chuán dào bù	mission
傷道	伤道	shāng dào	wound track (the path of a bullet through the body)
先王之道	先王之道	xiān wáng zhī dào	the way of former kings
入道	入道	rù dào	to enter the Way/to become a Daoist
內耳道	内耳道	nèi ěr dào	internal auditory meatus (canal in temporal bone of skull housing auditory nerves)
內行看門道，外行看熱鬧	内行看门道，外行看热闹	nèi háng kàn mén dao , wài háng kàn rè nao	while the connoisseur recognizes the artistry, the layman simply enjoys the show
全羅北道	全罗北道	Quán luó běi dào	North Jeolla Province, in west South Korea, capital Jeonju 全州[Quán zhōu]
全羅南道	全罗南道	Quán luó nán dào	South Jeolla Province, in southwest South Korea, capital Gwangju 光州[Guāng zhōu]
全羅道	全罗道	Quán luó dào	Jeolla or Cholla Province of Joseon Korea, now divided into North Jeolla Province 全羅北道|全罗北道[Quán luó běi dào] and South Jeolla Province 全羅南道|全罗南道[Quán luó nán dào]
兩江道	两江道	Liǎng jiāng dào	Ryanggang province province in north North Korea, adjacent to Jilin province
八正道	八正道	bā zhèng dao	the Eight-fold Noble Way (Buddhism)
八相成道	八相成道	bā xiàng chéng dào	the eight stages of the Buddha's life (Buddhism)
八道江	八道江	Bā dào jiāng	Badaojiang district in Baishan city 白山市, Jilin
八道江區	八道江区	Bā dào jiāng qū	Badaojiang district in Baishan city 白山市, Jilin
公共道德	公共道德	gōng gòng dào dé	public morality/social ethics
公道	公道	gōng dào	justice/fairness/public highway
公道	公道	gōng dao	fair/equitable
共同閘道介面	共同闸道介面	gòng tóng zhá dào jiè miàn	Common Gateway Interface/CGI
共行車道	共行车道	gòng xíng chē dào	carpool lane
冥道	冥道	míng dào	the gateway to the ghost world
出道	出道	chū dào	to make one's first public performance (of an entertainer etc)/to start one's career
分巡兵備道	分巡兵备道	Fēn xún Bīng Bèi dào	Qing Dynasty General Supervisory and Military Command
分道揚鑣	分道扬镳	fēn dào yáng biāo	lit. to take different roads and urge the horses on (idiom)/fig. to part ways
劍道	剑道	jiàn dào	kendō (sports)
力道	力道	lì dào	strength/power/efficacy
劫道	劫道	jié dào	to kidnap/to hijack
北海道	北海道	Běi hǎi dào	Hokkaidō, Japan
匝道	匝道	zā dào	freeway ramp
卑不足道	卑不足道	bēi bù zú dào	not worth mentioning
卑卑不足道	卑卑不足道	bēi bēi bù zú dào	to be too petty or insignificant to mention/to not be worth mentioning (idiom)
厚道	厚道	hòu dao	kind and honest/generous/sincere
原道	原道	yuán dào	original path/essay by Tang philosopher Han Yu 韓愈|韩愈
反人道罪	反人道罪	fǎn rén dào zuì	a crime against humanity
反人道罪行	反人道罪行	fǎn rén dào zuì xíng	crime against humanity
反其道而行之	反其道而行之	fǎn qí dào ér xíng zhī	to do the very opposite/to act in a diametrically opposite way
反赤道流	反赤道流	fǎn chì dào liú	equatorial counter current
取道	取道	qǔ dào	via/by way of/en route to
口碑載道	口碑载道	kǒu bēi zài dào	lit. praise fills the roads (idiom); praise everywhere/universal approbation
古縴道	古纤道	Gǔ Qiàn dào	Old Towpath along the Grand Canal in Zhejiang Province
古道	古道	gǔ dào	ancient road/precepts of the antiquity
叫道	叫道	jiào dào	to call/to shout
合氣道	合气道	hé qì dào	aikido (Japanese martial art)/hapkido (Korean martial art)
同道	同道	tóng dào	same principle
同道中人	同道中人	tóng dào zhōng rén	kindred spirit
同道者	同道者	tóng dào zhě	fellow-traveler/like-minded person
味道	味道	wèi dao	flavor/smell/hint of
呼吸道	呼吸道	hū xī dào	respiratory tract
咸鏡北道	咸镜北道	Xián jìng běi dào	North Hamgyeong Province in northeast of North Korea, capital Chongjin 清津市[Qīng jīn shì]
咸鏡南道	咸镜南道	Xián jìng nán dào	South Hamgyeong Province of east North Korea
咸鏡道	咸镜道	Xián jìng Dào	Hamgyeong Province of Joseon dynasty Korea, now divided into North Hamgyeong Province 咸鏡北道|咸镜北道[Xián jìng běi dào] and South Hamgyeong Province 咸鏡南道|咸镜南道[Xián jìng nán dào] of North Korea
唐手道	唐手道	Táng shǒu dào	Tang soo do (Korean martial art)
問道	问道	wèn dào	to ask the way/to ask
問道於盲	问道于盲	wèn dào yú máng	lit. to ask a blind man the way (idiom)/fig. to seek advice from an incompetent
喊道	喊道	hǎn dào	to yell
喝道	喝道	hè dào	(of yamen bailiffs etc) to walk ahead of an official, shouting at pedestrians to clear the way
單行道	单行道	dān xíng dào	one-way street
國道	国道	guó dào	national highway
圓軌道	圆轨道	yuán guǐ dào	circular orbit (in astronomy and in astronautics)
地下通道	地下通道	dì xià tōng dào	underpass/subway/tunnel
地地道道	地地道道	dì dì dào dào	thoroughgoing/authentic/100%/to the core
地球軌道	地球轨道	dì qiú guǐ dào	earth orbit
地道	地道	dì dào	tunnel/causeway
地道	地道	dì dao	authentic/genuine/proper
坐而論道	坐而论道	zuò ér lùn dào	to sit and pontificate; to find answers through theory and not through practice (idiom)
坑道	坑道	kēng dào	mine shaft/gallery/tunnel
坡道	坡道	pō dào	road on a slope/inclined path/ramp
報道	报道	bào dào	to report (news)/report/CL:篇[piān],份[fèn]
報道攝影師	报道摄影师	bào dào shè yǐng shī	photojournalist
塑膠跑道	塑胶跑道	sù jiāo pǎo dào	synthetic athletics track/tartan track
墓道	墓道	mù dào	path leading to a grave/tomb passage/aisle leading to the coffin chamber of an ancient tomb
外耳道	外耳道	wài ěr dào	external auditory meatus/auditory canal, between the outer ear 外耳 and tympanum 鼓膜
大修道院	大修道院	dà xiū dào yuàn	abbey/large monastery or convent
大修道院長	大修道院长	dà xiū dào yuàn zhǎng	abbot
大行其道	大行其道	dà xíng qí dào	rampant/very popular
大逆不道	大逆不道	dà nì bù dào	disgraceful (of behavior that is unfilial, rebellious or otherwise in grave breach of the norms of society)
大道	大道	dà dào	main street/avenue
大道具	大道具	dà dào jù	(theater) set prop (desk, chairs etc)
大道理	大道理	dà dào li	major principle/general truth/sermon (reproof)/bombastic talk
天公地道	天公地道	tiān gōng dì dào	absolutely fair and reasonable (idiom); equitable
天球赤道	天球赤道	tiān qiú chì dào	celestial equator
天道	天道	tiān dào	natural law/heavenly law/weather (dialect)
天道酬勤	天道酬勤	tiān dào chóu qín	Heaven rewards the diligent. (idiom)
夫子自道	夫子自道	Fū zǐ zì dào	appearing to be praising others while actually praising yourself/one's criticism of others exposes one's own faults
失道	失道	shī dào	to lose the way/unjust/moral failing
失道寡助	失道寡助	shī dào guǎ zhù	an unjust cause finds little support (idiom, from Mencius)/cf 得道多助[dé dào duō zhù] a just cause attracts much support
夾道	夹道	jiā dào	a narrow street (lined with walls)/to line the street
夾道歡迎	夹道欢迎	jiā dào huān yíng	to line the streets in welcome
女修道	女修道	nǚ xiū dào	convent
女修道張	女修道张	nǚ xiū dào zhāng	abbess
女修道院	女修道院	nǚ xiū dào yuàn	convent
好道	好道	hǎo dào	don't tell me .../could it be that...?
婦道人家	妇道人家	fù dao rén jia	woman (derog.)
孔孟之道	孔孟之道	Kǒng Mèng zhī dào	the teaching of Confucius and Mencius
孔道	孔道	kǒng dào	opening providing access/the teaching of Confucius
孝道	孝道	xiào dao	filial piety (Confucian virtue)/to be a good son or daughter
安貧樂道	安贫乐道	ān pín lè dào	to be content with poverty and strive for virtue (idiom)
安道爾	安道尔	Ān dào ěr	Andorra
安道爾共和國	安道尔共和国	Ān dào ěr Gòng hé guó	Republic of Andorra
安道爾城	安道尔城	Ān dào ěr chéng	Andorra la Vella, capital of Andorra
宣道	宣道	xuān dào	to preach (the gospel)
家道	家道	jiā dào	family financial circumstances
家道中落	家道中落	jiā dào zhōng luò	to come down in the world (idiom)/to suffer a reversal of fortune
尊師貴道	尊师贵道	zūn shī guì dào	to revere the master and his teaching
小道	小道	xiǎo dào	bypath/trail/bribery as a means of achieving a goal/minor arts (Confucian reference to agriculture, medicine, divination, and other professions unworthy of a gentleman)
小道具	小道具	xiǎo dào jù	(theater) hand prop (wine glass, pistol etc)
小道新聞	小道新闻	xiǎo dào xīn wén	news from the grapevine
小道消息	小道消息	xiǎo dào xiāo xi	hearsay/gossip
就道	就道	jiù dào	to set off/to take to the road
尾水渠道	尾水渠道	wěi shuǐ qú dào	outflow channel
尿生殖管道	尿生殖管道	niào shēng zhí guǎn dào	urinogenital tract
尿道	尿道	niào dào	urethra/urinary tract
山道年	山道年	shān dào nián	santonin (loanword)
岔道	岔道	chà dào	side road/byway
左道惑眾	左道惑众	zuǒ dào huò zhòng	to delude the masses with heretical doctrines (idiom)
布道	布道	bù dào	to preach (the Christian gospel)
常道	常道	cháng dào	normal and proper practice/conventional practice/common occurrence
平交道	平交道	píng jiāo dào	level crossing
平安北道	平安北道	Píng ān běi dào	North P'yong'an Province in west of North Korea, adjacent to Liaoning
平安南道	平安南道	Píng ān nán dào	South P'yong'an Province in west of North Korea
平安道	平安道	Píng ān dào	P'yong'ando Province of Joseon Korea, now divided into South Pyong'an Province 平安南道[Píng ān nán dào] and North Pyong'an Province 平安北道[Píng ān běi dào] of North Korea
幹道	干道	gàn dào	arterial road/main road/main watercourse
康莊大道	康庄大道	kāng zhuāng dà dào	broad and open road (idiom); fig. brilliant future prospects
彈道	弹道	dàn dào	trajectory (of a projectile)/ballistic curve
彈道導彈	弹道导弹	dàn dào dǎo dàn	ballistic missile
彎道	弯道	wān dào	winding road/road curve
彎道超車	弯道超车	wān dào chāo chē	to overtake on a bend (driving)/(fig.) taking opportunity of tight corners to make swift progress (economy etc)
徑道	径道	jìng dào	path/short-cut
得道	得道	dé dào	to achieve the Dao/to become an immortal
得道多助	得道多助	dé dào duō zhù	a just cause enjoys abundant support (idiom); those upholding justice will find help all around
得道多助，失道寡助	得道多助，失道寡助	dé dào duō zhù , shī dào guǎ zhù	A just cause attracts much support, an unjust one finds little (idiom, from Mencius)
循道宗	循道宗	Xún dào zōng	Methodism
微不足道	微不足道	wēi bù zú dào	negligible/insignificant
志同道合	志同道合	zhì tóng dào hé	like-minded (idiom)/fellow enthusiast/kindred spirit
忠清北道	忠清北道	Zhōng qīng běi dào	North Chungcheong Province, South Korea, capital Cheongju 清州市
忠清南道	忠清南道	Zhōng qīng nán dào	South Chungcheong Province, South Korea, capital Daejeon 大田[Dà tián]
忠清道	忠清道	Zhōng qīng dào	Chungcheong Province of Joseon Korea, now divided into North Chungcheong province 忠清北道[Zhōng qīng běi dào] and South Chungcheong province 忠清南道[Zhōng qīng nán dào] of South Korea
快行道	快行道	kuài xíng dào	fast lane/express lane
快車道	快车道	kuài chē dào	fast lane
怨天載道	怨天载道	yuàn tiān zài dào	lit. cries of complaint fill the roads (idiom); complaints rise all around/discontent is openly voiced
怨聲載道	怨声载道	yuàn shēng zài dào	lit. cries of complaint fill the roads (idiom); complaints rise all around/discontent is openly voiced
怪道	怪道	guài dào	no wonder!
悲聲載道	悲声载道	bēi shēng zài dào	lamentations fill the roads (idiom); severe suffering all around
慈江道	慈江道	Cí jiāng dào	Chagang province, in the north of North Korea
慕道友	慕道友	mù dào yǒu	religious investigator
慘無人道	惨无人道	cǎn wú rén dào	inhuman (idiom)/brutal and unfeeling
慢行道	慢行道	màn xíng dào	slow lane
慶尚北道	庆尚北道	Qìng shàng běi dào	North Gyeongsang Province, in east South Korea, capital Daegu 大邱[Dà qiū]
慶尚南道	庆尚南道	Qìng shàng nán dào	South Gyeongsang Province, in southeast South Korea, capital Changwon 昌原[Chāng yuán]
慶尚道	庆尚道	Qìng shàng dào	Gyeongsang Province of Joseon Korea, now divided into North Gyeongsang Province 慶尚北道|庆尚北道[Qìng shàng běi dào] and South Gyeongsang Province 慶尚南道|庆尚南道[Qìng shàng nán dào]
成道	成道	chéng dào	to reach illumination (Buddhism)
截拳道	截拳道	jié quán dào	Jeet Kun Do or Way of the Intercepting Fist, a fusion of Eastern and Western martial arts led by Bruce Lee 李小龍|李小龙[Lǐ Xiǎo lóng]
打交道	打交道	dǎ jiāo dào	to come into contact with/to have dealings
打道回府	打道回府	dǎ dào huí fǔ	to go home (in a ceremonial procession)/to return home
扳道	扳道	bān dào	railroad switch
扳道員	扳道员	bān dào yuán	pointsman/switchman
扳道岔	扳道岔	bān dào chà	railroad switch
抄道	抄道	chāo dào	to take a shortcut
拖牽索道	拖牵索道	tuō qiān suǒ dào	anchor lift (ski-lift)
拱道	拱道	gǒng dào	archway
據報道	据报道	jù bào dào	according to a report/It is reported that...
擺了一道	摆了一道	bǎi le yī dào	to play tricks on/to make a fool of
擺事實講道理	摆事实讲道理	bǎi shì shí jiǎng dào lǐ	present the facts and reason things out
攀親道故	攀亲道故	pān qīn dào gù	to use claims to kinship or friendship to climb socially (idiom)
改道	改道	gǎi dào	to change route/to divert (a road or a watercourse)
故道	故道	gù dào	old road/old way/old course (of a river)
數黃道黑	数黄道黑	shǔ huáng dào hēi	to enumerate what is black and yellow (idiom); to criticize sb behind his back to incite quarrels/also written 數黑論黃|数黑论黄[shǔ hēi lùn huáng]
文以載道	文以载道	wén yǐ zài dào	words of truth/moral expressed in words/written article explaining a moral
新慕道團	新慕道团	xīn mù dào tuán	neo Catechumenal way
旁門左道	旁门左道	páng mén zuǒ dào	dissenting religious sect (idiom); heretical school of opinion/dissident group
日本黑道	日本黑道	Rì běn Hēi dào	Yakuza (Japanese mafia)
早知道	早知道	zǎo zhī dao	If I had known earlier...
明修棧道，暗渡陳倉	明修栈道，暗渡陈仓	míng xiū zhàn dào , àn dù Chén cāng	lit. repair the plank road by day while secretly crossing the Wei River 渭河[Wèi Hé] at Chencang (idiom, refers to a stratagem used by Liu Bang 劉邦|刘邦[Liú Bāng] in 206 BC against Xiang Yu 項羽|项羽[Xiàng Yǔ] of Chu)/fig. to feign one thing while doing another/to cheat under cover of a diversion
暗道	暗道	àn dào	secret passage/secret tunnel
有失厚道	有失厚道	yǒu shī hòu dao	to be ungenerous
有道	有道	yǒu dào	to have attained the Way/(of a government or a ruler) enlightened/wise and just
有道是	有道是	yǒu dào shì	as they say, .../as the saying goes, ...
有道理	有道理	yǒu dào li	to make sense/reasonable
朝鮮八道	朝鲜八道	Cháo xiǎn bā dào	the eight provinces of Yi dynasty Korea
李政道	李政道	Lǐ Zhèng dào	Tsung-Dao Lee (1926-), Chinese American physicist, Columbia University, 1957 Nobel laureate
杜塞道夫	杜塞道夫	Dù sè dào fū	Düsseldorf (Germany)/also written 杜塞爾多夫|杜塞尔多夫[Dù sāi ěr duō fū]
東道	东道	dōng dào	host
東道主	东道主	dōng dào zhǔ	host/official host (e.g. venue for games or a conference)
林蔭大道	林荫大道	lín yìn dà dào	see 林陰大道|林阴大道[lín yīn dà dào]
林蔭道	林荫道	lín yìn dào	boulevard/avenue/mall
林陰大道	林阴大道	lín yīn dà dào	boulevard/tree-lined avenue/CL:條|条[tiáo]
林陰道	林阴道	lín yīn dào	see 林蔭道|林荫道[lín yìn dào]
架空索道	架空索道	jià kōng suǒ dào	aerial ropeway/cable car
柔道	柔道	róu dào	judo
柯南·道爾	柯南·道尔	Kē nán · Dào ěr	Sir Arthur Conan Doyle (1859-1930), author of the Sherlock Holmes stories 歇洛克·福爾摩斯|歇洛克·福尔摩斯
棧道	栈道	zhàn dào	plank walkway constructed on the face of a cliff/(archaic) elevated passageway connecting the upper levels of adjacent towers
極道	极道	jí dào	yakuza
樁構棧道	桩构栈道	zhuāng gòu zhàn dào	pile trestle
樂道	乐道	lè dào	to take delight in talking about sth/to find pleasure in following one's convictions
樓道	楼道	lóu dào	corridor/passageway (in storied building)
橫斷步道	横断步道	héng duàn bù dào	pedestrian crossing
橫行霸道	横行霸道	héng xíng bà dào	to oppress/to rule as a despot/to tyrannize
正道	正道	zhèng dào	the correct path/the right way (Buddhism)
此道	此道	cǐ dào	such matters/things like this/this line of work/this pursuit/this hobby/this endeavor
步道	步道	bù dào	walking path/pathway
武士道	武士道	wǔ shì dào	bushidō or way of the warrior, samurai code of chivalry
歪門邪道	歪门邪道	wāi mén xié dào	dishonest practices
殉道	殉道	xùn dào	to die for a just cause
氣道	气道	qì dào	flue/air duct/air passage/respiratory tract
水道	水道	shuǐ dào	aqueduct/sewer
水道口	水道口	shuǐ dào kǒu	mouth of sewer
求道於盲	求道于盲	qiú dào yú máng	see 問道於盲|问道于盲[wèn dào yú máng]
江原道	江原道	Jiāng yuán dào	Gangwon Province of Korea during Joseon Dynasty/Kangwon province of North Korea/Gangwon province in northeast South Korea, capital Chuncheon 春川[Chūn chuān]
汪道涵	汪道涵	Wāng Dào hán	Wang Daohan (1915-2005), former president of the Association for Relations Across the Taiwan Straits
河道	河道	hé dào	river course/river channel
津津樂道	津津乐道	jīn jīn lè dào	to discuss sth enthusiastically
洲際彈道導彈	洲际弹道导弹	zhōu jì dàn dào dǎo dàn	intercontinental ballistic missile ICBM
消化道	消化道	xiāo huà dào	digestive tract
清道	清道	qīng dào	to clean the street/to clear the road (i.e. get rid of people for passage of royalty or VIP)
清道夫	清道夫	qīng dào fū	street cleaner/garbage collector/(soccer) sweeper
渠道	渠道	qú dào	irrigation ditch/(fig.) channel/means
溝道	沟道	gōu dào	groove
滑出跑道	滑出跑道	huá chū pǎo dào	runway (at airport)
滑行道	滑行道	huá xíng dào	taxiway (at airport)
滑雪索道	滑雪索道	huá xuě suǒ dào	ski-lift
滴道	滴道	Dī dào	Didao district of Jixi city 雞西|鸡西[Jī xī], Heilongjiang
滴道區	滴道区	Dī dào qū	Didao district of Jixi city 雞西|鸡西[Jī xī], Heilongjiang
濟州特別自治道	济州特别自治道	Jì zhōu tè bié zì zhì dào	Jeju island special autonomous province, South Korea, a World Heritage site
無道	无道	wú dào	tyrannical/brutal (regime)
熟道	熟道	shú dào	familiar road/well-trodden path
熟道兒	熟道儿	shú dào r5	familiar road/well-trodden path
王道	王道	wáng dào	the Way of the King/statecraft/benevolent rule/virtuous as opposed to the Way of Hegemon 霸道
現場報道	现场报道	xiàn chǎng bào dào	on-the-spot report
球道	球道	qiú dào	fairway (golf)/lane (ten-pin bowling)
生財有道	生财有道	shēng cái yǒu dào	lit. there are principles behind making money (idiom); fig. to have a knack for good business/knowing how to accumulate wealth/good at feathering one's own nest
產道	产道	chǎn dào	birth canal (in obstetrics)
甬道	甬道	yǒng dào	walled-in path/paved pathway/canopied passageway/corridor/tunnel
男修道院長	男修道院长	nán xiū dào yuàn zhǎng	abbot
當道	当道	dāng dào	in the middle of the road/to be in the way/to hold power/(fig.) to predominate/to be in vogue
白道	白道	bái dào	lunar orbit/legitimate/righteous/see also 黑道[hēi dào]
百度知道	百度知道	Bǎi dù Zhī dao	Baidu Knows, online Q & A forum, zhidao.baidu.com
盤道	盘道	pán dào	twining mountain road
直道而行	直道而行	zhí dào ér xíng	lit. to go straight (idiom, from Analects); to act with integrity
真道	真道	zhēn dào	the true way
知道	知道	zhī dào	to know/to become aware of/also pr. [zhī dao]
知道了	知道了	zhī dào le	OK!/Got it!
祆道	祆道	Xiān dào	Zoroastrianism/see also 祆教[Xiān jiào]
神道	神道	Shén dào	Shinto (Japanese religion)
秦嶺蜀棧道	秦岭蜀栈道	Qín lǐng shǔ zhàn dào	the Qinling plank road to Shu, a historical mountain road from Shaanxi to Sichuan
稱道	称道	chēng dào	to commend/to praise
穴道	穴道	xué dào	acupuncture point/acupoint
空手道	空手道	kōng shǒu dào	karate
竇道	窦道	dòu dào	subterranean passage/(medicine) sinus
管道	管道	guǎn dào	tubing/pipeline/(fig.) channel/means
管道運輸	管道运输	guǎn dào yùn shū	pipeline transport
築室道謀	筑室道谋	zhù shì dào móu	lit. ask passers-by how to build one's house (idiom); fig. to have no idea what to do/without a clue
精於此道	精于此道	jīng yú cǐ dào	to be proficient in the area of/skilled in this field
糞道	粪道	fèn dào	coprodeum (in birds)
糧道	粮道	liáng dào	route for providing foodstuff
索道	索道	suǒ dào	ropeway
綜合報道	综合报道	zōng hé bào dào	comprehensive report/consolidated report
縴道	纤道	qiàn dào	towpath (along a canal)
繞道	绕道	rào dào	to go by a roundabout route/to take a detour/(medicine or civil engineering) bypass
羊腸小道	羊肠小道	yáng cháng xiǎo dào	road as twisty as sheep's intestine (idiom); narrow and winding road/fig. complicated and tricky job
聲道	声道	shēng dào	sound track/audio channel
胃繞道	胃绕道	wèi rào dào	gastric bypass
胃腸道	胃肠道	wèi cháng dào	gastrointestinal tract
背道而馳	背道而驰	bèi dào ér chí	to run in the opposite direction (idiom); to run counter to
胡說八道	胡说八道	hú shuō bā dào	to talk rubbish
胡謅亂道	胡诌乱道	hú zhōu luàn dào	to talk nonsense (idiom); saying whatever comes into his head
能說會道	能说会道	néng shuō huì dào	can talk really well (idiom); the gift of the gab
腕隧道症候群	腕隧道症候群	wàn suì dào zhèng hòu qún	carpal tunnel syndrome (pain in the hands due to pressure on the median nerve)/median neuropathy at the wrist
腸胃道	肠胃道	cháng wèi dào	digestive tract
腸道	肠道	cháng dào	intestines/gut
膽道	胆道	dǎn dào	bile duct/biliary tract
自動步道	自动步道	zì dòng bù dào	moving walkway/travelator
航道	航道	háng dào	waterway/ship channel
苦集滅道	苦集灭道	kǔ jí miè dào	the Four Noble Truths (Budd.), namely: all life is suffering 苦, the cause of suffering is desire 集, emancipation comes only by eliminating passions 滅|灭, the way 道 to emancipation is the Eight-fold Noble Way 八正道/also called 四諦|四谛
茶道	茶道	chá dào	Japanese tea ceremony/sado
茶馬古道	茶马古道	Chá mǎ gǔ dào	old tea-horse road or southern Silk Road, dating back to 6th century, from Tibet and Sichuan through Yunnan and Southeast Asia, reaching to Bhutan, Sikkim, India and beyond
菩提道場	菩提道场	Pú tí dào chǎng	Bodhimanda (place of enlightenment associated with a Bodhisattva)
華容道	华容道	Huá róng Dào	Huarong Road (traditional puzzle involving sliding wooden blocks, loosely based on an episode in Three Kingdoms 三國演義|三国演义[Sān guó Yǎn yì])
著道兒	着道儿	zháo dào r5	to be fooled/to be taken in (by a ruse)
蘭鄭長成品油管道	兰郑长成品油管道	Lán Zhèng Cháng chéng pǐn yóu guǎn dào	Lanzhou-Zhengzhou-Changsha oil pipeline
蘭鄭長管道	兰郑长管道	Lán Zhèng Cháng guǎn dào	Lanzhou-Zhengzhou-Changsha oil pipeline
處世之道	处世之道	chǔ shì zhī dào	way of life/attitude/modus operandi
街道	街道	jiē dào	street/CL:條|条[tiáo]/subdistrict/residential district
街道辦事處	街道办事处	jiē dào bàn shì chù	subdistrict office/neighborhood official/an official who works with local residents to report to higher government authorities
衛道	卫道	wèi dào	to defend traditional values
衛道士	卫道士	wèi dào shì	traditionalist/moralist/champion (of a cause)
袁宏道	袁宏道	Yuán Hóng dào	Yuan Hongdao (1568-1610), Ming dynasty poet and travel writer
裝飾道具	装饰道具	zhuāng shì dào jù	(theater) set dressing/trim prop
要道	要道	yào dào	major road/thoroughfare/main road
記者報道	记者报道	jì zhě bào dào	press report
語音通訊通道	语音通讯通道	yǔ yīn tōng xùn tōng dào	voice (communications) channel
說一千，道一萬	说一千，道一万	shuō yī qiān , dào yī wàn	when all is said and done/at the end of the day
說三道四	说三道四	shuō sān dào sì	to make thoughtless remarks (idiom)/to criticize/gossip
說道	说道	shuō dào	to state/to say (the quoted words)
說道	说道	shuō dao	to discuss/reason (behind sth)
說長道短	说长道短	shuō cháng dào duǎn	lit. to discuss sb's merits and demerits (idiom); to gossip
誰知道	谁知道	shéi zhī dào	God knows.../Who would have imagined...?
論長道短	论长道短	lùn cháng dào duǎn	lit. to discuss sb's merits and demerits (idiom); to gossip
講道	讲道	jiǎng dào	to preach/a sermon
變道	变道	biàn dào	to change lanes
豺狼當道	豺狼当道	chái láng dāng dào	ravenous wolves hold the road (idiom); wicked people in power/a vicious tyranny rules the land
貧道	贫道	pín dào	poor Taoist
賽道	赛道	sài dào	race course
赤道	赤道	chì dào	equator (of the earth or astronomical body)
赤道儀	赤道仪	chì dào yí	equatorial mount (for a telescope)
赤道幾內亞	赤道几内亚	Chì dào Jī nèi yà	Equatorial Guinea
赤道逆流	赤道逆流	chì dào nì liú	equatorial counter current
赤道雨林	赤道雨林	chì dào yǔ lín	equatorial rain forest
走道	走道	zǒu dào	pavement/sidewalk/path/walk/footpath/aisle
跆拳道	跆拳道	tái quán dào	taekwondo (Korean martial art)
跑道	跑道	pǎo dào	athletic track/track/runway (i.e. airstrip)
踩道	踩道	cǎi dào	to scout/to reconnoiter
車行通道	车行通道	chē xíng tōng dào	traffic passage
車行道	车行道	chē xíng dào	roadway/carriageway
車道	车道	chē dào	traffic lane/driveway
軋道機	轧道机	yà dào jī	road roller
軋道車	轧道车	yà dào chē	trolley for inspecting rail track
軌道	轨道	guǐ dào	orbit/railway or tram line/fig. conventional way of thinking
軌道交通	轨道交通	guǐ dào jiāo tōng	metro/rapid transit/subway
軌道空間站	轨道空间站	guǐ dào kōng jiān zhàn	orbiting space station
軌道艙	轨道舱	guǐ dào cāng	orbital module/orbital cabin
載人軌道空間站	载人轨道空间站	zài rén guǐ dào kōng jiān zhàn	manned orbiting space station
載道	载道	zài dào	to fill the road (also fig. clamor, cries of complaint)/to communicate a moral/to convey the Way/to express (idea, preference, complaint)
輕型軌道交通	轻型轨道交通	qīng xíng guǐ dào jiāo tōng	light rail/transit system (underground, at street level or elevated)/streetcar/metro/abbr. to 輕軌|轻轨[qīng guǐ]
轉道	转道	zhuǎn dào	to make a detour/to go by way of
近地軌道	近地轨道	jìn dì guǐ dào	low Earth orbit (LEO)
近道	近道	jìn dào	shortcut/a quicker method
送上軌道	送上轨道	sòng shàng guǐ dào	to send into orbit
通訊通道	通讯通道	tōng xùn tōng dào	communications channel
通道	通道	Tōng dào	Tongdao Dong autonomous county in Huaihua 懷化|怀化[Huái huà], Hunan
通道	通道	tōng dào	(communications) channel/thoroughfare/passage
通道侗族自治縣	通道侗族自治县	Tōng dào Dòng zú Zì zhì xiàn	Tongdao Dong Autonomous County in Huaihua 懷化|怀化[Huái huà], Hunan
通道縣	通道县	Tōng dào xiàn	Tongdao Dong autonomous county in Huaihua 懷化|怀化[Huái huà], Hunan
進道若蜷	进道若蜷	jìn dào ruò quán	entering the Way, you seem to coil back (Laozi 老子[Lǎo zǐ], the Book of Dao 道德经, Chap. 14)/progress in the Dao can seem illusory
進道若退	进道若退	jìn dào ruò tuì	progress seems like regress (the Book of Dao 道德經|道德经[Dào dé jīng], Chpt. 41)
運道	运道	yùn dao	fortune/luck/fate
過道	过道	guò dào	passageway/corridor/aisle
一人得道，雞犬升天	一人得道，鸡犬升天	yī rén dé dào , jī quǎn shēng tiān	lit. when a man achieves the Dao, his poultry and dogs rise to Heaven (idiom)/fig. to ride on sb else's success/Once one man gets a government position, all his cronies get in too/Once sb has cracked the problem, every Tom, Dick and Harry can do it
道不同不相為謀	道不同不相为谋	dào bù tóng bù xiāng wéi móu	lit. persons who walk different paths cannot make plans together/to go separate ways (idiom)
道不拾遺	道不拾遗	dào bù shí yí	lit. no one picks up lost articles in the street (idiom)/fig. honesty prevails throughout society
道之所存，師之所存	道之所存，师之所存	dào zhī suǒ cún , shī zhī suǒ cún	If sb has grasped the truth before you, take him as your teacher (Tang dynasty essayist Han Yu 韓愈|韩愈)./We should learn from one who knows the way.
道人	道人	dào rén	Taoist devotee (honorific)
道光	道光	Dào guāng	reign name of Qing emperor (1821-1850)
道光帝	道光帝	Dào guāng dì	Daoguang Emperor
道具	道具	dào jù	prop (theater)/paraphernalia/(gaming) item/artifact
道具服	道具服	dào jù fú	costume
道出	道出	dào chū	to speak/to tell/to voice
道別	道别	dào bié	leave-taking/to say goodbye
道卡斯族	道卡斯族	Dào kǎ sī zú	Taokas, one of the indigenous peoples of Taiwan
道喜	道喜	dào xǐ	to congratulate
道地	道地	dào dì	authentic/original
道場	道场	dào chǎng	Taoist or Buddhist rite/abbr. for 菩提道場|菩提道场[Pú tí dào chǎng]
道士	道士	dào shì	Daoist priest
道外	道外	Dào wài	Daowai district of Harbin 哈爾濱|哈尔滨[Hā ěr bīn] in Heilongjiang
道外區	道外区	Dào wài qū	Daowai district of Harbin 哈爾濱|哈尔滨[Hā ěr bīn] in Heilongjiang
道奇	道奇	Dào qí	Dodge, US automobile brand, division of Chrysler LLC
道姑	道姑	dào gū	Daoist nun
道孚	道孚	Dào fú	Dawu county (Tibetan: rta 'u rdzong) in Garze Tibetan autonomous prefecture 甘孜藏族自治州[Gān zī Zàng zú zì zhì zhōu], Sichuan (formerly in Kham province of Tibet)
道孚縣	道孚县	Dào fú xiàn	Dawu county (Tibetan: rta 'u rdzong) in Garze Tibetan autonomous prefecture 甘孜藏族自治州[Gān zī Zàng zú zì zhì zhōu], Sichuan (formerly in Kham province of Tibet)
道學	道学	dào xué	Confucian study of ethics/study of Daoism/school for Daoism in Tang and Song times/Daoist magic/another name for 理學|理学, rational learning of Song dynasty neo-Confucianism
道家	道家	Dào jiā	Daoist School of the Warring States Period (475-221 BC), based on the teachings of Laozi or Lao-tze 老子[Lǎo zǐ] (c. 500 BC-) and Zhuangzi 庄子 (369-286 BC)
道山學海	道山学海	dào shān xué hǎi	mountain of Dao, sea of learning (idiom); learning is as high as the mountains, as wide as the seas/ars longa, vita brevis
道岔	道岔	dào chà	railroad switch
道德	道德	dào dé	virtue/morality/ethics/CL:種|种[zhǒng]
道德困境	道德困境	dào dé kùn jìng	ethical dilemma
道德家	道德家	dào dé jiā	Daoist
道德敗壞	道德败坏	dào dé bài huài	vice/immorality/moral turpitude
道德淪喪	道德沦丧	dào dé lún sàng	moral bankruptcy/moral degeneracy
道德經	道德经	Dào dé jīng	the Book of Dao by Laozi or Lao-Tze, the sacred text of Daoism
道德認識	道德认识	dào dé rèn shi	moral cognition/ethical awareness
道所存者，乃師所存者	道所存者，乃师所存者	dào suǒ cún zhě , nǎi shī suǒ cún zhě	If sb has grasped the truth before you, take him as your teacher (Tang dynasty essayist Han Yu 韓愈|韩愈)./We should learn from one who knows the way.
道拉吉里峰	道拉吉里峰	Dào lā jí lǐ Fēng	Dhaulagiri, mountain massif in the Himalayas
道指	道指	Dào zhǐ	Dow Jones Industrial Average (abbr. for 道瓊斯指數|道琼斯指数[Dào Qióng sī Zhǐ shù])
道教	道教	Dào jiào	Taoism/Daoism (Chinese system of beliefs)
道教徒	道教徒	Dào jiào tú	a Daoist/a follower of Daoism
道格拉斯	道格拉斯	Dào gé lā sī	Douglas (name)
道格拉斯·麥克阿瑟	道格拉斯·麦克阿瑟	Dào gé lā sī · Mài kè ā sè	General Douglas MacArthur (1880-1964), US commander in Pacific during WW2, sacked in 1951 by President Truman for exceeding orders during the Korean war
道歉	道歉	dào qiàn	to apologize
道爾頓	道尔顿	Dào ěr dùn	Dalton (name)/John Dalton (1766-1844), British scientist who contributed to atomic theory
道牙	道牙	dào yá	curb
道理	道理	dào li	reason/argument/sense/principle/basis/justification/CL:個|个[gè]
道瓊	道琼	Dào Qióng	Dow Jones (stock market index)
道瓊斯	道琼斯	Dào Qióng sī	Dow Jones (stock market index)
道瓊斯指數	道琼斯指数	Dào Qióng sī Zhǐ shù	Dow Jones Industrial Average
道白	道白	dào bái	spoken lines in opera
道真仡佬族苗族自治縣	道真仡佬族苗族自治县	Dào zhēn Gē lǎo zú Miáo zú Zì zhì xiàn	Daozhen Klau and Hmong Autonomous County in Zunyi 遵義|遵义[Zūn yì], northeast Guizhou
道真縣	道真县	Dào zhēn xiàn	Daozhen Klau and Hmong autonomous county in Zunyi 遵義|遵义[Zūn yì], northeast Guizhou
道真自治縣	道真自治县	Dào zhēn Zì zhì xiàn	Daozhen Klau and Hmong autonomous county in Zunyi 遵義|遵义[Zūn yì], northeast Guizhou
道破	道破	dào pò	to expose/to reveal
道碴	道碴	dào chá	(railway) ballast
道統	道统	dào tǒng	Confucian orthodoxy
道縣	道县	Dào xiàn	Dao county in Yongzhou 永州[Yǒng zhōu], Hunan
道義	道义	dào yì	morality/righteousness and justice
道聽途說	道听途说	dào tīng tú shuō	gossip/hearsay/rumor
道臺	道台	dào tái	(Ming and Qing dynasties) daotai (title for an official responsible for supervising a circuit 道|道[dào]), aka taotai and circuit intendant
道藏	道藏	dào zàng	Daoist scripture
道行	道行	dào héng	skills acquired through religious practice/(fig.) ability/skill/Taiwan pr. [dào hang]
道袍	道袍	dào páo	Taoist robe/traditional men's gown
道觀	道观	dào guàn	Daoist temple
道謝	道谢	dào xiè	to express thanks
道貌岸然	道貌岸然	dào mào àn rán	sanctimonious/dignified
道賀	道贺	dào hè	to congratulate
道路	道路	dào lù	road/path/way/CL:條|条[tiáo]
道路工程	道路工程	dào lù gōng chéng	road construction
道里	道里	Dào lǐ	Daoli district of Harbin 哈爾濱|哈尔滨[Hā ěr bīn] in Heilongjiang
道里區	道里区	Dào lǐ qū	Daoli district of Harbin 哈爾濱|哈尔滨[Hā ěr bīn] in Heilongjiang
道長	道长	Dào Zhǎng	Taoist priest/Daoist priest
道院	道院	dào yuàn	Daoyuan (Sanctuary of the Dao)
道高一尺，魔高一丈	道高一尺，魔高一丈	dào gāo yī chǐ , mó gāo yī zhàng	virtue is one foot tall, the devil ten foot (idiom); It takes constant vigilance to stave off evil.
道高益安，勢高益危	道高益安，势高益危	dào gāo yì ān , shì gāo yì wēi	More moral strength increases one's safety, more power and influence increases one's danger (idiom, from Records of the Historian 史記|史记). cf Unlimited power is apt to corrupt the minds of those who possess it (William Pitt the Elder, 1770).
邪道	邪道	xié dào	depraved life/evil ways/fornication
邪門歪道	邪门歪道	xié mén wāi dào	lit. devil's gate, crooked path (idiom); corrupt practices/crooked methods/dishonesty
醫道	医道	Yī dào	Hur Jun (TV series)
醫道	医道	yī dào	art of healing/medical skill
鐵道	铁道	tiě dào	railway line/rail track
鐵道部	铁道部	Tiě dào bù	Ministry of Railways (MOR), disbanded in 2013 with its regulatory functions taken over by the Ministry of Transport 交通運輸部|交通运输部[Jiāo tōng Yùn shū bù]
門道	门道	mén dào	doorway/gateway
門道	门道	mén dao	the way to do sth/knack
開道	开道	kāi dào	to clear the way
開鑼喝道	开锣喝道	kāi luó hè dào	to clear a street by banging gongs and shouting loudly (idiom)
閘道	闸道	zhá dào	(computing) gateway (Tw)
防毒通道	防毒通道	fáng dú tōng dào	protective passageway
阿道司·赫胥黎	阿道司·赫胥黎	Ā dào sī · Hè xū lì	Aldous Huxley (1894-1963), British novelist and author of Brave New World 美麗新世界|美丽新世界[Měi lì Xīn Shì jiè]
降落跑道	降落跑道	jiàng luò pǎo dào	runway (at airport)
陰道	阴道	yīn dào	vagina
陰道口	阴道口	yīn dào kǒu	female external genitalia (anatomy)/vulva
陰道棕櫚狀壁	阴道棕榈状壁	yīn dào zōng lǘ zhuàng bì	palmate folds of cervical canal/plicae palmatae canalis cervicis uteri
陰道炎	阴道炎	yīn dào yán	vaginal infection/inflammation of the vulva or vagina/colpitis
陳再道	陈再道	Chén Zài dào	Chen Zaidao (1909-1993), general in the People's Liberation Army
陽道	阳道	yáng dào	penis
陽關大道	阳关大道	Yáng guān Dà dào	(lit.) the road through Yangguan 陽關|阳关[Yáng guān]/(fig.) wide open road/bright future
陽關道	阳关道	Yáng guān Dào	same as 陽關大道|阳关大道[Yáng guān Dà dào]
隧道	隧道	suì dào	tunnel
隨身道具	随身道具	suí shēn dào jù	(theater) personal prop (spectacles, fan etc)
雙節棍道	双节棍道	shuāng jié gùn dào	nunchaku martial arts
離經叛道	离经叛道	lí jīng pàn dào	to rebel against orthodoxy/to depart from established practices
難道	难道	nán dào	don't tell me .../could it be that...?
霸王之道	霸王之道	Bà wáng zhī dào	the Way of the Hegemon/despotic rule/abbr. to 霸道
霸道	霸道	bà dào	the Way of the Hegemon/abbr. for 霸王之道/despotic rule/rule by might/evil as opposed to the Way of the King 王道/overbearing/tyranny/(of liquor, medicine etc) strong/potent
霸道總裁	霸道总裁	bà dào zǒng cái	handsome high-powered businessman (a type of character in an eponymous genre of romantic fiction who typically has a soft spot for a girl of lower social status)
靠走道	靠走道	kào zǒu dào	on the aisle (referring to seats on a plane etc)
順道	顺道	shùn dào	on the way
頌聲載道	颂声载道	sòng shēng zài dào	lit. praise fills the roads (idiom); praise everywhere/universal approbation
頭道	头道	tóu dào	first time/first (round, course, coat of paint etc)
頭頭是道	头头是道	tóu tóu shì dào	clear and logical
頻道	频道	pín dào	frequency/(television) channel
額勒貝格·道爾吉	额勒贝格·道尔吉	É lè bèi gé · Dào ěr jí	Elbegdorj Tsakhia or Tsakhia-giin Elbegdorj (1963-), Mongolian US educated Democratic Party politician, president of Mongolia from 2009
飛躍道	飞跃道	fēi yuè dào	parkour (HK)
食道	食道	shí dào	esophagus/the proper way to eat/food transportation route
食道癌	食道癌	shí dào ái	esophageal cancer
養生之道	养生之道	yǎng shēng zhī dào	the way of maintaining good health
餓殍載道	饿殍载道	è piǎo zài dào	starved corpses fill the roads (idiom); state of famine
餓莩載道	饿莩载道	è piǎo zài dào	starved corpses fill the roads (idiom); state of famine
馳道	驰道	chí dào	(old) highway for the emperor/highway
高架道路	高架道路	gāo jià dào lù	elevated road
魔高一丈，道高一尺	魔高一丈，道高一尺	mó gāo yī zhàng , dào gāo yī chǐ	the devil is ten foot tall, virtue one foot (idiom); It takes constant vigilance to stave off evil.
鳥道	鸟道	niǎo dào	a road only a bird can manage/steep dangerous road
鳴鑼開道	鸣锣开道	míng luó kāi dào	to beat the gong to clear the way/(fig.) to pave the way for sth
麥道	麦道	Mài dào	McDonnell Douglas (plane company)
黃海北道	黄海北道	Huáng Hǎi běi dào	North Hwanghae Province of west North Korea
黃海南道	黄海南道	Huáng Hǎi nán dào	South Hwanghae Province of west North Korea
黃海道	黄海道	Huáng hǎi dào	former Hwanghae Province of northwest Korea, divided into North and South Hwanghae Province of North Korea in 1954
黃道	黄道	huáng dào	the ecliptic (the plane of the solar system)
黃道十二宮	黄道十二宫	huáng dào shí èr gōng	see 十二宮|十二宫[shí èr gōng]
黑道	黑道	hēi dào	dark road/criminal ways/the underworld/see also 白道[bái dào]
黑道家族	黑道家族	Hēi dào Jiā zú	The Sopranos (US TV series)
