粗	粗	cū	coarse/rough/thick (for cylindrical objects)/unfinished/vulgar/rude/crude
觕	粗	cū	variant of 粗[cū]
麤	粗	cū	remote/distant/variant of 粗[cū]
大凡粗知	大凡粗知	dà fán cū zhī	a rough acquaintance with sth
大老粗	大老粗	dà lǎo cū	uncouth fellow/rustic
抱粗腿	抱粗腿	bào cū tuǐ	to latch on to the rich and powerful
挾細拿粗	挟细拿粗	xié xì ná cū	to provoke
氣粗	气粗	qì cū	irascible/overbearing
皮膚粗糙	皮肤粗糙	pí fū cū cāo	pachylosis
短粗	短粗	duǎn cū	stocky (short and robust)
磨石粗砂岩	磨石粗砂岩	mó shí cū shā yán	millstone grit
加粗	加粗	jiā cū	to make text bold
粗估	粗估	cū gū	rough estimate
粗俗	粗俗	cū sú	vulgar
粗劣	粗劣	cū liè	coarse
粗劣作品	粗劣作品	cū liè zuò pǐn	kitsch/vulgar art/art in bad taste
粗厲	粗厉	cū lì	abrasive/husky (voice)
粗口	粗口	cū kǒu	swear words/obscene language/foul language
粗啞	粗哑	cū yǎ	husky/hoarse/raucous
粗壯	粗壮	cū zhuàng	thick and solid
粗大	粗大	cū dà	thick/bulky/loud
粗心	粗心	cū xīn	careless/thoughtless
粗心大意	粗心大意	cū xīn dà yì	negligent/careless/inadvertent
粗放	粗放	cū fàng	extensive/expansive/large-scale
粗暴	粗暴	cū bào	rough/cruel
粗枝大葉	粗枝大叶	cū zhī dà yè	thick stems and broad leaves (idiom)/boorish/rough and ready/sloppy
粗榧	粗榧	cū fěi	Chinese plum-yew/Cephalotaxus sinensis (botany)
粗活	粗活	cū huó	unskilled labor/heavy manual work
粗淺	粗浅	cū qiǎn	shallow/superficial
粗獷	粗犷	cū guǎng	rough/rude/boorish/straightforward/uninhibited
粗率	粗率	cū shuài	rough/coarse/crude/without due care/ill-considered
粗略	粗略	cū lüè	rough (not precise or accurate)/cursory
粗疏	粗疏	cū shū	coarse/rough/careless
粗砂	粗砂	cū shā	grit
粗笨	粗笨	cū bèn	awkward/clumsy/unwieldy/heavy-handed
粗管麵	粗管面	cū guǎn miàn	rigatoni
粗糙	粗糙	cū cāo	crude/gruff/rough/coarse
粗糧	粗粮	cū liáng	coarse grains (maize, sorghum etc)
粗糲	粗粝	cū lì	coarse rice/coarse (of food)
粗細	粗细	cū xì	thick and thin/coarse and fine/thickness (caliber)/coarseness/quality of work
粗茶淡飯	粗茶淡饭	cū chá dàn fàn	plain tea and simple food/(fig.) bread and water
粗莽	粗莽	cū mǎng	brusque/rough/boorish/crude
粗製濫造	粗制滥造	cū zhì làn zào	to churn out large quantities without regard for quality (idiom); rough and slipshod work
粗話	粗话	cū huà	vulgar language (esp. scatological insults)/uncultured speech
粗語	粗语	cū yǔ	rude words/dirty talk
粗豪	粗豪	cū háo	straightforward/forthright
粗鄙	粗鄙	cū bǐ	vulgar/coarse/uncouth
粗野	粗野	cū yě	insolent/boorish/rough (in actions)
粗陋	粗陋	cū lòu	crude/coarse/unsophisticated/shallow
粗飯	粗饭	cū fàn	an unappealing and unsatisfying meal
粗體	粗体	cū tǐ	bold (typeface)
粗體字	粗体字	cū tǐ zì	bold letter
粗魯	粗鲁	cū lǔ	coarse/crude (in one's manner)/boorish
粗魯不文	粗鲁不文	cū lǔ bù wén	crude and ill-educated (idiom)
粗鹵	粗卤	cū lǔ	variant of 粗魯|粗鲁[cū lǔ]
粗鹽	粗盐	cū yán	coarse salt/rock salt
老粗	老粗	lǎo cū	uneducated person/yokel/boor/roughneck
臉紅脖子粗	脸红脖子粗	liǎn hóng bó zi cū	red in the face/extremely angry
蒸粗麥粉	蒸粗麦粉	zhēng cū mài fěn	couscous
西雙版納粗榧	西双版纳粗榧	xī shuāng bǎn nà cū fěi	Cephalotaxus mannii (botany)
動粗	动粗	dòng cū	to use violence (against sb)/to strong-arm sb/to manhandle
財大氣粗	财大气粗	cái dà qì cū	rich and imposing/rich and overbearing
喘粗氣	喘粗气	chuǎn cū qì	to pant heavily
