慈	慈	cí	compassionate/gentle/merciful/kind/humane
仁慈	仁慈	rén cí	benevolent/charitable/kind/kindly/kindness/merciful
令慈	令慈	lìng cí	Your esteemed mother (honorific)
假慈悲	假慈悲	jiǎ cí bēi	phoney mercy/sham benevolence/crocodile tears
先慈	先慈	xiān cí	deceased mother
劉慈欣	刘慈欣	Liú Cí xīn	Liu Cixin (1963-), Chinese science fiction writer
嚴慈	严慈	yán cí	strict and compassionate/strict as a father and tender as a mother
大慈恩寺	大慈恩寺	Dà cí ēn sì	Daci'en Buddhist temple in Xi'an
子孝父慈	子孝父慈	zǐ xiào fù cí	see 父慈子孝[fù cí zǐ xiào]
宋慈	宋慈	Sòng Cí	Song Ci (1186-1249), Southern Song lawyer, editor of Record of Washed Grievances 洗冤集錄|洗冤集录 (1247), said to be the world's first legal forensic text
家慈	家慈	jiā cí	(polite) my mother
恩慈	恩慈	ēn cí	bestowed kindness
京都念慈菴	京都念慈菴	Jīng dū Niàn cí ān	King-to Nin Jiom, or just Nin Jiom, manufacturer of 枇杷膏[pí pá gāo] cough medicine
慈利	慈利	Cí lì	Cili county in Zhangjiajie 張家界|张家界[Zhāng jiā jiè], Hunan
慈利縣	慈利县	Cí lì xiàn	Cili county in Zhangjiajie 張家界|张家界[Zhāng jiā jiè], Hunan
慈和	慈和	cí hé	kindly/amiable
慈善	慈善	cí shàn	benevolent/charitable
慈善家	慈善家	cí shàn jiā	philanthropist/humanitarian/charity donor
慈善抽獎	慈善抽奖	cí shàn chōu jiǎng	a raffle (for charity)
慈善機構	慈善机构	cí shàn jī gòu	charity
慈善組織	慈善组织	cí shàn zǔ zhī	charity organization
慈姑	慈姑	cí gu	arrowhead (Sagittaria subulata, a water plant)
慈恩宗	慈恩宗	Cí ēn zōng	see 法相宗[Fǎ xiàng zōng]
慈悲	慈悲	cí bēi	mercy
慈悲為本	慈悲为本	cí bēi wéi běn	mercy as the guiding principle (idiom); the Buddhist teaching that nothing is valid except compassion
慈愛	慈爱	cí ài	love/devotion (to children)/affection, esp. towards children
慈母	慈母	cí mǔ	warm, caring mother
慈江道	慈江道	Cí jiāng dào	Chagang province, in the north of North Korea
慈溪	慈溪	Cí xī	Cixi county level city in Ningbo 寧波|宁波[Níng bō], Zhejiang
慈溪市	慈溪市	Cí xī shì	Cixi county level city in Ningbo 寧波|宁波[Níng bō], Zhejiang
慈照寺	慈照寺	Cí zhào sì	Jishōji in northeast Kyōto 京都, Japan, the official name of Ginkakuji or Silver pavilion 銀閣寺|银阁寺[yín gé sì]
慈眉善目	慈眉善目	cí méi shàn mù	kind brows, pleasant eyes (idiom); amiable looking/benign-faced
慈眉善眼	慈眉善眼	cí méi shàn yǎn	kind brows, pleasant eyes (idiom); amiable looking/benign-faced
慈石	慈石	cí shí	magnetite Fe3O4
慈祥	慈祥	cí xiáng	kindly/benevolent (often of older person)
慈福行動	慈福行动	cí fú xíng dòng	Operation Blessing (charitable relief organization)
慈禧	慈禧	Cí Xǐ	Empress Dowager Cixi or Ts'u Hsi (reigned 1861-1908)
慈禧太后	慈禧太后	Cí xǐ tài hòu	Empress Dowager Cixi or Ts'u Hsi (1835-1908), regent 1861-1908
慈靄	慈霭	cí ǎi	kindly and amiable
慈顏	慈颜	cí yán	one's mother's loving face
父慈子孝	父慈子孝	fù cí zǐ xiào	benevolent father, filial son (idiom)/natural love between parents and children
賢淑仁慈	贤淑仁慈	xián shū rén cí	a virtuous and benevolent woman (idiom)
