黏	黏	nián	sticky/glutinous/(Tw) to adhere/to stick on/to glue
沾黏	沾黏	zhān nián	(Tw) to stick (to sth)/adhesion (medicine)
濕黏	湿黏	shī nián	clammy
膠黏	胶黏	jiāo nián	sticky/adhesive
膠黏劑	胶黏剂	jiāo nián jì	glue/adhesive
副黏液病毒	副黏液病毒	fù nián yè bìng dú	paramyxovirus
黏人	黏人	nián rén	(of a child) clingy/(of a pet) fond of interacting with people/friendly
黏住	黏住	nián zhù	cling
黏兒	黏儿	nián r5	gum/resin
黏合	黏合	nián hé	to glue together
黏合劑	黏合剂	nián hé jì	glue
黏土	黏土	nián tǔ	clay
黏土動畫	黏土动画	nián tǔ dòng huà	clay animation/Claymation
黏度	黏度	nián dù	viscosity (physics)
黏性	黏性	nián xìng	stickiness/gluing strength/viscosity
黏性力	黏性力	nián xìng lì	viscous force (physics)
黏扣帶	黏扣带	nián kòu dài	velcro (Tw)
黏木	黏木	nián mù	amonang tree (Ixonanthes chinensis)
黏涎	黏涎	nián xian	saliva/slobber/(coll.) long-winded/meandering
黏涎子	黏涎子	nián xián zi	saliva/dribble
黏液	黏液	nián yè	mucus
黏滑	黏滑	nián huá	slimy (of rotten food)/viscous/stick-slip (in mechanics)
黏滯	黏滞	nián zhì	viscous
黏滯性	黏滞性	nián zhì xìng	viscosity
黏痰	黏痰	nián tán	phlegm
黏稠	黏稠	nián chóu	viscous/thick
黏稠度	黏稠度	nián chóu dù	viscosity
黏答答	黏答答	nián dā dā	(unpleasantly) sticky
黏米	黏米	nián mǐ	sticky rice/short-grain rice/Oryza sativa var. japonica
黏糊	黏糊	nián hu	sticky/glutinous/slow-moving
黏糊糊	黏糊糊	nián hū hū	sticky
黏結	黏结	nián jié	to cohere/to bind
黏膜	黏膜	nián mó	mucous membrane
黏膠	黏胶	nián jiāo	viscose
黏膠液	黏胶液	nián jiāo yè	viscose
黏膩	黏腻	nián nì	sticky/clammy/(fig.) clingy/emotionally dependent
黏菌	黏菌	nián jūn	slime mold (Myxomycetes)
黏著	黏着	nián zhuó	to adhere/to stick together/to bond/to agglutinate/adhesion/adhesive
黏著力	黏着力	nián zhuó lì	adhesion/adhesive force
黏著性	黏着性	nián zhuó xìng	agglutinative (in linguistics, a characteristic of Altaic languages)
黏著語	黏着语	nián zhuó yǔ	agglutinative language (e.g. Turkish and Japanese)
黏貼	黏贴	nián tiē	to glue to/to paste onto/to stick on/also written 粘貼|粘贴[zhān tiē]
黏附	黏附	nián fù	to adhere/to stick to
黏附力	黏附力	nián fù lì	adhesive force/adherence/coherence
鼻黏膜	鼻黏膜	bí nián mó	nasal mucous membrane
