耗	耗	hào	to waste/to spend/to consume/to squander/news/(coll.) to delay/to dilly-dally
傷耗	伤耗	shāng hào	damage (e.g. to goods in transit)
內耗	内耗	nèi hào	internal friction/internal dissipation of energy (in mechanics)/fig. waste or discord within an organization
功耗	功耗	gōng hào	electric consumption/power wastage
噩耗	噩耗	è hào	news of sb's death/grievous news
回耗	回耗	huí hào	to write back/to send a reply
折耗	折耗	shé hào	loss of goods/damage to goods/shrinkage
損耗	损耗	sǔn hào	wear and tear
損耗品	损耗品	sǔn hào pǐn	consumables
核燃料燃耗	核燃料燃耗	hé rán liào rán hào	nuclear fuel burnup
油耗	油耗	yóu hào	fuel consumption
消耗	消耗	xiāo hào	to use up/to consume
消耗戰	消耗战	xiāo hào zhàn	war of attrition
消耗量	消耗量	xiāo hào liàng	rate of consumption
燃耗	燃耗	rán hào	fuel consumption
狗拿耗子	狗拿耗子	gǒu ná hào zi	lit. a dog who catches mice/to be meddlesome (idiom)
生耗氧量	生耗氧量	shēng hào yǎng liàng	biological oxygen demand (BOD)
瞎貓碰上死耗子	瞎猫碰上死耗子	xiā māo pèng shàng sǐ hào zi	a blind cat finds a dead mouse (idiom)/blind luck
磨耗	磨耗	mó hào	wear and tear/wearing out by friction
低耗	低耗	dī hào	low consumption (energy, fuel etc)
耗力	耗力	hào lì	to require much effort
耗失	耗失	hào shī	(of sth that should be retained: nutrients, moisture, heat etc) to be lost
耗子	耗子	hào zi	(dialect) mouse/rat
耗損	耗损	hào sǔn	to waste
耗散	耗散	hào sàn	to dissipate/to squander
耗時	耗时	hào shí	time-consuming/to take a period of (x amount of time)
耗時耗力	耗时耗力	hào shí hào lì	requiring much time and effort
耗材	耗材	hào cái	consumables/to consume raw materials
耗油量	耗油量	hào yóu liàng	fuel consumption
耗盡	耗尽	hào jìn	to exhaust/to use up/to deplete/to drain
耗能	耗能	hào néng	to consume energy/energy consumption
耗費	耗费	hào fèi	to waste/to spend/to consume/to squander
耗資	耗资	hào zī	to spend/expenditure/to cost
貓哭耗子	猫哭耗子	māo kū hào zi	the cat weeps for the dead mouse (idiom); hypocritical pretence of condolence/crocodile tears
音耗	音耗	yīn hào	message
