茶	茶	chá	tea/tea plant/CL:杯[bēi],壺|壶[hú]
下午茶	下午茶	xià wǔ chá	afternoon tea (light afternoon meal, typically pastries with tea or coffee)
兒茶素	儿茶素	ér chá sù	catechin (biochemistry)
功夫茶	功夫茶	gōng fu chá	very concentrated type of tea drunk in Chaozhou, Fujian and Taiwan
南非茶	南非茶	Nán fēi chá	rooibos tea
博士茶	博士茶	bó shì chá	rooibos tea
品茶	品茶	pǐn chá	to taste tea/to sip tea
喝茶	喝茶	hē chá	(fig.) to have a meeting with state security agents (to be warned to behave "responsibly")
奶茶	奶茶	nǎi chá	milk tea
山茶	山茶	shān chá	camellia
山茶花	山茶花	shān chá huā	camellia
工夫茶	工夫茶	gōng fu chá	very concentrated type of tea consumed in Chaozhou, Fujian and Taiwan/variant of 功夫茶[gōng fu chá]
抹茶	抹茶	mǒ chá	green tea powder (Japanese: matcha)
拉茶	拉茶	lā chá	teh tarik, an Indian-style tea with milk (GM)
敬茶	敬茶	jìng chá	to serve tea (to guests)
早茶	早茶	zǎo chá	morning tea
春茶	春茶	chūn chá	tea leaves gathered at springtime or the tea made from these leaves
普洱茶	普洱茶	Pǔ ěr chá	Pu'er tea from the Pu'er region of Yunnan
末茶	末茶	mò chá	tea powder (matcha)
柴米油鹽醬醋茶	柴米油盐酱醋茶	chái mǐ yóu yán jiàng cù chá	lit. firewood, rice, oil, salt, soy, vinegar, and tea/fig. life's daily necessities
格雷伯爵茶	格雷伯爵茶	Gé léi Bó jué chá	Earl Grey tea
檸檬茶	柠檬茶	níng méng chá	lemon tea
殘茶剩飯	残茶剩饭	cán chá shèng fàn	spoilt tea, leftover food (idiom); remains after a meal/crumbs from the feast
毛茶	毛茶	máo chá	unprocessed sun-dried tea leaves used to make black or green tea
沙茶	沙茶	shā chá	satay (spicy peanut sauce), also spelled sate
沱茶	沱茶	tuó chá	a cake of tea, commonly Pu'er tea 普洱茶[Pǔ ěr chá], compacted into a bowl or nest shape/dome shaped tea-brick/caked tea
泡茶	泡茶	pào chá	to make tea
波霸奶茶	波霸奶茶	bō bà nǎi chá	bubble milk tea (Tw)/Boba milk tea/tapioca milk tea/see also 珍珠奶茶[zhēn zhū nǎi chá]
涼茶	凉茶	liáng chá	Chinese herb tea
清茶	清茶	qīng chá	green tea/only tea (without food)
烏龍茶	乌龙茶	wū lóng chá	oolong tea
烹茶	烹茶	pēng chá	to brew tea
熱茶	热茶	rè chá	hot tea
燒茶	烧茶	shāo chá	to make tea
玄米茶	玄米茶	xuán mǐ chá	genmaicha/Japanese tea with added roasted brown rice
珍珠奶茶	珍珠奶茶	zhēn zhū nǎi chá	pearl milk tea/tapioca milk tea/bubble milk tea
珠茶	珠茶	zhū chá	gunpowder tea, Chinese green tea whose leaves are each formed into a small pellet
矮地茶	矮地茶	ǎi dì chá	(loanword) Japanese ardisia (Ardisia japonica) (herb)
粗茶淡飯	粗茶淡饭	cū chá dàn fàn	plain tea and simple food/(fig.) bread and water
紅灌木茶	红灌木茶	hóng guàn mù chá	rooibos tea
紅茶	红茶	hóng chá	black tea/CL:杯[bēi],壺|壶[hú]
紅茶菌	红茶菌	hóng chá jūn	kombucha (fermented tea)
綠茶	绿茶	lǜ chá	green tea
綠茶婊	绿茶婊	lǜ chá biǎo	"green tea bitch", a girl who seems innocent and charming but is actually calculating and manipulative
肉骨茶	肉骨茶	ròu gǔ chá	bak-kut-teh or pork ribs soup, popular in Malaysia and Singapore
花茶	花茶	huā chá	scented tea/CL:杯[bēi],壺|壶[hú]
茉莉花茶	茉莉花茶	mò li huā chá	jasmine tea
三茶六飯	三茶六饭	sān chá liù fàn	lit. to offer three kinds of tea and six different dishes/to be extremely considerate towards guests (idiom)
茶具	茶具	chá jù	tea set/tea service
茶几	茶几	chá jī	small side table/coffee table/teapoy (ornamental tripod with caddies for tea)
茶包	茶包	chá bāo	tea bag/(slang) trouble (loanword)
茶匙	茶匙	chá chí	teaspoon
茶坊	茶坊	chá fáng	teahouse
茶垢	茶垢	chá gòu	tea stain (on the inside of a tea pot, tea cup etc)
茶壺	茶壶	chá hú	teapot/CL:把[bǎ]
茶座	茶座	chá zuò	teahouse/tea-stall with seats/tea-garden or teahouse seat
茶房	茶房	chá fáng	waiter/steward/porter/teahouse
茶敘	茶叙	chá xù	to take tea and chat/a small-scale informal gathering with tea and snacks
茶晶	茶晶	chá jīng	yellow quartz/topaz
茶會	茶会	chá huì	tea party
茶杯	茶杯	chá bēi	teacup/tea-glass/cup/mug/CL:隻|只[zhī]
茶樓	茶楼	chá lóu	tearoom/teahouse/dimsum restaurant (Hong Kong)
茶樹	茶树	chá shù	tea tree/Camellia sinensis
茶水	茶水	chá shuǐ	tea prepared in large quantity using inexpensive tea leaves
茶碗	茶碗	chá wǎn	teacup
茶經	茶经	Chá jīng	the Classic of Tea, first monograph ever on tea and its culture, written by 陸羽|陆羽[Lù Yǔ] between 760-780
茶缸	茶缸	chá gāng	mug
茶缸子	茶缸子	chá gāng zi	mug/tea mug
茶聚	茶聚	chá jù	informal gathering with refreshments provided
茶胸斑啄木鳥	茶胸斑啄木鸟	chá xiōng bān zhuó mù niǎo	(bird species of China) fulvous-breasted woodpecker (Dendrocopos macei)
茶色	茶色	chá sè	dark brown/tawny
茶花	茶花	chá huā	camellia
茶莊	茶庄	chá zhuāng	tea shop
茶葉	茶叶	chá yè	tea/tea leaves/CL:盒[hé],罐[guàn],包[bāo],片[piàn]
茶葉末兒	茶叶末儿	chá yè mò r5	tea leaves powder
茶葉蛋	茶叶蛋	chá yè dàn	tea egg (egg boiled with flavorings which may include black tea)
茶藝	茶艺	chá yì	the art of tea
茶藨子	茶藨子	chá biāo zi	gooseberry
茶袋	茶袋	chá dài	tea bag
茶褐色	茶褐色	chá hè sè	dark brown/tawny
茶話會	茶话会	chá huà huì	tea party
茶農	茶农	chá nóng	tea grower
茶道	茶道	chá dào	Japanese tea ceremony/sado
茶錢	茶钱	chá qián	tip/gratuity/money for tea
茶鏽	茶锈	chá xiù	tea stain (on the inside of a tea pot, tea cup etc)
茶陵	茶陵	Chá líng	Chaling county in Zhuzhou 株洲, Hunan
茶陵縣	茶陵县	Chá líng xiàn	Chaling county in Zhuzhou 株洲, Hunan
茶隼	茶隼	chá sǔn	kestrel/common Eurasian falcon (Falco tinnunculus)
茶飯不思	茶饭不思	chá fàn bù sī	no thought for tea or rice (idiom); melancholic and suffering/to have no appetite
茶飯無心	茶饭无心	chá fàn wú xīn	no heart for tea or rice (idiom); melancholic and suffering/to have no appetite
茶餘酒後	茶余酒后	chá yú jiǔ hòu	see 茶餘飯後|茶余饭后[chá yú fàn hòu]
茶餘飯後	茶余饭后	chá yú fàn hòu	leisure time (over a cup of tea, after a meal etc)
茶餘飯飽	茶余饭饱	chá yú fàn bǎo	see 茶餘飯後|茶余饭后[chá yú fàn hòu]
茶館	茶馆	chá guǎn	teahouse/CL:家[jiā]
茶館兒	茶馆儿	chá guǎn r5	a teashop
茶馬互市	茶马互市	Chá mǎ hù shì	old tea-horse market between Tibet, China, Southeast Asia and India, formalized as a state enterprise under the Song dynasty
茶馬古道	茶马古道	Chá mǎ gǔ dào	old tea-horse road or southern Silk Road, dating back to 6th century, from Tibet and Sichuan through Yunnan and Southeast Asia, reaching to Bhutan, Sikkim, India and beyond
茶鹼	茶碱	chá jiǎn	Theophylline
茶點	茶点	chá diǎn	tea and cake/refreshments/tea and dimsun 點心|点心, traditional Hong Kong lunch
茶點時間	茶点时间	chá diǎn shí jiān	tea break/tea and dimsun 點心|点心, traditional Hong Kong lunch
菊花茶	菊花茶	jú huā chá	chrysanthemum tea
貢茶	贡茶	Gòng chá	Gong Cha, international franchise selling Taiwan-style milk tea and smoothies etc, established in Kaohsiung in 2006
酥油茶	酥油茶	sū yóu chá	butter tea (Tibetan, Mongolian etc drink derived from milk)
長島冰茶	长岛冰茶	Cháng dǎo bīng chá	Long Island Iced Tea
飲茶	饮茶	yǐn chá	to have tea and refreshments/to have dimsum lunch (Cantonese)
黑茶	黑茶	hēi chá	dark tea, a variety of fermented tea (e.g. Pu'er tea 普洱茶[Pǔ ěr chá])
黑茶藨子	黑茶藨子	hēi chá biāo zi	blackcurrant/cassis
龍井茶	龙井茶	lóng jǐng chá	Longjing (tea)
