奮	奋	fèn	to exert oneself (bound form)
令人振奮	令人振奋	lìng rén zhèn fèn	inspiring/exciting/rousing
勤奮	勤奋	qín fèn	hardworking/diligent
勤奮刻苦	勤奋刻苦	qín fèn kè kǔ	diligent/assiduous
反興奮劑	反兴奋剂	fǎn xīng fèn jì	anti-doping/anti-stimulant/policy against drugs in sports
天才出自勤奮	天才出自勤奋	tiān cái chū zì qín fèn	genius comes from hard effort/Genius is one percent inspiration and ninety-nine percent perspiration (Thomas Edison)
亢奮	亢奋	kàng fèn	excited/stimulated
奮不顧身	奋不顾身	fèn bù gù shēn	to dash on bravely with no thought of personal safety (idiom); undaunted by dangers/regardless of perils
奮力	奋力	fèn lì	to do everything one can/to spare no effort/to strive
奮勇	奋勇	fèn yǒng	dauntless/to summon up courage and determination/using extreme force of will
奮戰	奋战	fèn zhàn	to fight bravely/(fig.) to struggle/to work hard
奮武揚威	奋武扬威	fèn wǔ yáng wēi	a show of strength
奮發	奋发	fèn fā	to rouse to vigorous action/energetic mood
奮發圖強	奋发图强	fèn fā tú qiáng	to work energetically for prosperity (of the country)
奮筆疾書	奋笔疾书	fèn bǐ jí shū	to write at a tremendous speed
奮袂	奋袂	fèn mèi	to roll up one's sleeves for action
奮起	奋起	fèn qǐ	to rise vigorously/a spirited start
奮起湖	奋起湖	Fèn qǐ hú	Fenchihu, town in Chiayi County, Taiwan
奮起直追	奋起直追	fèn qǐ zhí zhuī	to catch up vigorously/to set off in hot pursuit
奮進	奋进	fèn jìn	to advance bravely/to endeavor
奮進號	奋进号	Fèn jìn Hào	Space Shuttle Endeavor
奮飛	奋飞	fèn fēi	to spread wings and fly
奮鬥	奋斗	fèn dòu	to strive/to struggle
孤軍奮戰	孤军奋战	gū jūn fèn zhàn	lit. lone army putting up a brave fight (idiom)/fig. (of a person or group of people) struggling hard without support
感奮	感奋	gǎn fèn	moved and inspired/fired with enthusiasm
振奮	振奋	zhèn fèn	to stir oneself up/to raise one's spirits/to inspire
昂奮	昂奋	áng fèn	buoyant/high-spirited/vigorous
激奮	激奋	jī fèn	aroused/excited
發奮	发奋	fā fèn	to make an effort/to push for sth/to work hard
發奮圖強	发奋图强	fā fèn tú qiáng	to make an effort to become strong (idiom); determined to do better/to pull one's socks up
發奮有為	发奋有为	fā fèn yǒu wéi	to prove one's worth through firm resolve (idiom)
自告奮勇	自告奋勇	zì gào fèn yǒng	to volunteer for/to offer to undertake
興奮	兴奋	xīng fèn	excited/excitement/(physiology) excitation
興奮劑	兴奋剂	xīng fèn jì	stimulant/doping (in athletics)
興奮高潮	兴奋高潮	xīng fèn gāo cháo	peak of excitement/orgasm
艱苦奮鬥	艰苦奋斗	jiān kǔ fèn dòu	to struggle arduously
鄒韜奮	邹韬奋	Zōu Tāo fèn	Zou Taofen (1895-1944), journalist, political theorist and publisher
