鋼	钢	gāng	steel
不銹鋼	不锈钢	bù xiù gāng	stainless steel
不鏽鋼	不锈钢	bù xiù gāng	stainless steel
人是鐵飯是鋼	人是铁饭是钢	rén shì tiě fàn shì gāng	one can't function properly on an empty stomach (idiom)/an empty sack cannot stand upright
刺鋼絲	刺钢丝	cì gāng sī	barbed wire
加料鋼琴	加料钢琴	jiā liào gāng qín	prepared piano
塑鋼	塑钢	sù gāng	acetal resin/Delrin/unplasticized polyvinyl chloride (uPVC or rigid PVC)
大鋼琴	大钢琴	dà gāng qín	grand piano
威而鋼	威而钢	Wēi ér gāng	Viagra (male impotence drug)
寶鋼	宝钢	Bǎo gāng	Baosteel, China's largest steel maker
寶鋼集團	宝钢集团	Bǎo gāng Jí tuán	Baosteel, China's largest steel maker
小鋼珠	小钢珠	xiǎo gāng zhū	pachinko
小鋼球	小钢球	xiǎo gāng qiú	iron pellet/shrapnel
小鋼砲	小钢炮	xiǎo gāng pào	(coll.) piece of light artillery such as a mortar/(fig.) person who speaks boldly and frankly/hot hatch (car)/(also used figuratively with various meanings in other contexts)
工字鋼	工字钢	gōng zì gāng	I-beam
廢鋼	废钢	fèi gāng	scrap metal/steel scrap
恨鐵不成鋼	恨铁不成钢	hèn tiě bù chéng gāng	lit. to hate iron for not becoming steel/to feel resentful towards sb for failing to meet expectations and impatient to see improvement (idiom)
槽鋼	槽钢	cáo gāng	steel groove/V-shaped steel bar
武漢鋼鐵公司	武汉钢铁公司	Wǔ hàn Gāng tiě Gōng sī	Wuhan Iron and Steel
無鋼圈	无钢圈	wú gāng quān	wireless (bra)
煉鋼	炼钢	liàn gāng	steelmaking
煉鋼廠	炼钢厂	liàn gāng chǎng	steel mill
玻璃鋼	玻璃钢	bō li gāng	glass-reinforced plastic/fiberglass
白鋼	白钢	bái gāng	steel
百煉成鋼	百炼成钢	bǎi liàn chéng gāng	to be tempered into a steel
百煉鋼	百炼钢	bǎi liàn gāng	high-grade well-tempered steel
舞鋼	舞钢	Wǔ gāng	Wugang county level city in Pingdingshan 平頂山|平顶山[Píng dǐng shān], Henan
舞鋼市	舞钢市	Wǔ gāng shì	Wugang county level city in Pingdingshan 平頂山|平顶山[Píng dǐng shān], Henan
走鋼絲	走钢丝	zǒu gāng sī	to walk a tightrope (literally or figuratively)
軋鋼	轧钢	zhá gāng	to roll steel (into sheets or bars)
軋鋼廠	轧钢厂	zhá gāng chǎng	a steel rolling mill
軋鋼條	轧钢条	zhá gāng tiáo	steel rails
軋鋼機	轧钢机	zhá gāng jī	a steel rolling mill
鋒鋼	锋钢	fēng gāng	high speed steel
上海寶鋼集團公司	上海宝钢集团公司	Shàng hǎi Bǎo gāng Jí tuán Gōng sī	Baosteel
鋼刀	钢刀	gāng dāo	steel knife/sword
鋼化玻璃	钢化玻璃	gāng huà bō li	reinforced glass
鋼叉	钢叉	gāng chā	pitchfork/garden fork/restraining pole (used by police)/military fork (of ancient times)
鋼圈	钢圈	gāng quān	wheel rim/underwire (in a bra)
鋼坯	钢坯	gāng pī	billet (steel industry)
鋼廠	钢厂	gāng chǎng	a steelworks
鋼彈	钢弹	Gāng dàn	Gundam, Japanese animation franchise
鋼曲尺	钢曲尺	gāng qū chǐ	steel set square (tool to measure right angles)
鋼材	钢材	gāng cái	steel (as raw material)/steel sheets, bars, tubes, ingots, wire etc
鋼板	钢板	gāng bǎn	steel plate
鋼柱	钢柱	gāng zhù	iron pillar/iron rod
鋼梁	钢梁	gāng liáng	steel beam/girder
鋼條	钢条	gāng tiáo	steel bar
鋼槍	钢枪	gāng qiāng	rifle
鋼片琴	钢片琴	gāng piàn qín	celesta
鋼珠	钢珠	gāng zhū	steel ball/bearing ball
鋼琴	钢琴	gāng qín	piano/CL:架[jià],臺|台[tái]
鋼琴家	钢琴家	gāng qín jiā	pianist
鋼琴師	钢琴师	gāng qín shī	pianist
鋼琴演奏	钢琴演奏	gāng qín yǎn zòu	piano performance
鋼盔	钢盔	gāng kuī	metal helmet/(military) helmet
鋼窗	钢窗	gāng chuāng	metal window
鋼筆	钢笔	gāng bǐ	fountain pen/CL:支[zhī]
鋼筋	钢筋	gāng jīn	steel reinforcing bar
鋼筋水泥	钢筋水泥	gāng jīn shuǐ ní	reinforced concrete
鋼筋混凝土	钢筋混凝土	gāng jīn hùn níng tǔ	reinforced concrete
鋼管	钢管	gāng guǎn	steel pipe/pole (in pole dancing)
鋼管舞	钢管舞	gāng guǎn wǔ	pole dancing
鋼箭	钢箭	gāng jiàn	iron arrow
鋼絲	钢丝	gāng sī	steel wire/tightrope
鋼絲繩	钢丝绳	gāng sī shéng	hawser/steel rope
鋼絲鋸	钢丝锯	gāng sī jù	jigsaw (saw with steel wire blade)
鋼纜	钢缆	gāng lǎn	steel cable/wire cable/steel hawser
鋼花	钢花	gāng huā	the fiery spray of molten steel
鋼製	钢制	gāng zhì	made of steel/steel (bar, screw, product etc)
鋼軌	钢轨	gāng guǐ	steel rail
鋼鋸	钢锯	gāng jù	hacksaw
鋼鏰	钢镚	gāng bèng	small coin/dime
鋼鐱	钢钎	gāng qiān	a steel drill
鋼鐵	钢铁	gāng tiě	steel
鋼鐵俠	钢铁侠	Gāng tiě xiá	Iron Man, comic book superhero
鋼鐵學院	钢铁学院	Gāng tiě Xué yuàn	Beijing Steel and Iron Institute (the former name of 北京科技大學|北京科技大学[Běi jīng Kē jì Dà xué], University of Science and Technology Beijing)
鋼鐵工業	钢铁工业	gāng tiě gōng yè	steel industry
鋼鐵廠	钢铁厂	gāng tiě chǎng	iron and steel works/steelworks
鋼鞭	钢鞭	gāng biān	mace (weapon)
鋼骨水泥	钢骨水泥	gāng gǔ shuǐ ní	reinforced concrete
