常	常	Cháng	surname Chang
常	常	cháng	always/ever/often/frequently/common/general/constant
一如往常	一如往常	yī rú wǎng cháng	as usual
三綱五常	三纲五常	sān gāng wǔ cháng	three principles and five virtues (idiom)/the three rules (ruler guides subject, father guides son and husband guides wife) and five constant virtues of Confucianism (benevolence 仁, righteousness 義|义, propriety 禮|礼, wisdom 智 and fidelity 信)
不主故常	不主故常	bù zhǔ gù cháng	not to stick to the old conventions
不平常	不平常	bù píng cháng	remarkable/remarkably/unusual
不正常	不正常	bù zhèng cháng	abnormal
不正常狀況	不正常状况	bù zhèng cháng zhuàng kuàng	abnormal state
中常	中常	zhōng cháng	ordinary/average/medium/mid-range/moderate
五常	五常	Wǔ cháng	Wuchang county level city in Harbin 哈爾濱|哈尔滨, Heilongjiang
五常	五常	wǔ cháng	five constant virtues of Confucianism, namely: benevolence 仁, righteousness 義|义, propriety 禮|礼, wisdom 智 and fidelity 信/five cardinal relationships of Confucianism (between ruler and subject, father and son, husband and wife, brothers, friends)/five phases of Chinese philosophy: water 水, fire 火, wood 木, metal 金, earth 土
五常市	五常市	Wǔ cháng shì	Wuchang county level city in Harbin 哈爾濱|哈尔滨, Heilongjiang
人之常情	人之常情	rén zhī cháng qíng	human nature (idiom)/a behavior that is only natural
介電常數	介电常数	jiè diàn cháng shù	dielectric constant
倫常	伦常	lún cháng	proper human relationships
全國人大常委會	全国人大常委会	Quán guó Rén Dà Cháng Wěi huì	Standing Committee of the National People's Congress (abbr. of 全國人民代表大會常務委員會|全国人民代表大会常务委员会)
全國人民代表大會常務委員會	全国人民代表大会常务委员会	Quán guó Rén mín Dài biǎo Dà huì Cháng wù Wěi yuán huì	Standing Committee of the National People's Congress
兵家常事	兵家常事	bīng jiā cháng shì	commonplace in military operations (idiom)
出沒無常	出没无常	chū mò wú cháng	to appear and disappear unpredictably
十常侍	十常侍	shí cháng shì	Ten Permanent Functionaries at the end of Han, a byword for corruption
千里馬常有，而伯樂不常有	千里马常有，而伯乐不常有	qiān lǐ mǎ cháng yǒu , ér Bó Lè bù cháng yǒu	lit. there are many swift horses, but very few who can spot them (idiom)/fig. many have talent, but few can recognize talent when they see it
反常	反常	fǎn cháng	unusual/abnormal
反覆無常	反复无常	fǎn fù wú cháng	unstable/erratic/changeable/fickle
喜怒無常	喜怒无常	xǐ nù wú cháng	temperamental/moody
基因染色體異常	基因染色体异常	jī yīn rǎn sè tǐ yì cháng	genetic chromosome abnormality
太常	太常	tài cháng	Minister of Ceremonies in imperial China, one of the Nine Ministers 九卿[jiǔ qīng]
失常	失常	shī cháng	not normal/an aberration
定常態	定常态	dìng cháng tài	constant state/fixed state
家常	家常	jiā cháng	the daily life of a family
家常便飯	家常便饭	jiā cháng biàn fàn	simple home-style meal/common occurrence/nothing out of the ordinary
家常菜	家常菜	jiā cháng cài	home cooking
家常豆腐	家常豆腐	jiā cháng dòu fu	home-style tofu
尋常	寻常	xún cháng	usual/common/ordinary
一反常態	一反常态	yī fǎn cháng tài	complete change from the normal state (idiom); quite uncharacteristic/entirely outside the norm/out of character
一反往常	一反往常	yī fǎn wǎng cháng	contrary to usual/unlike what usually happens
常人	常人	cháng rén	ordinary person
常任	常任	cháng rèn	permanent
常任理事國	常任理事国	cháng rèn lǐ shì guó	permanent member state (of UN Security Council)
常住	常住	cháng zhù	long-term resident/permanent residence/eternalism (permanence of soul, Sanskrit śāśvata-vāda)
常住論	常住论	cháng zhù lùn	eternalism (permanence of soul, Sanskrit śāśvata-vāda)
常來常往	常来常往	cháng lái cháng wǎng	to visit frequently/to have frequent dealings (with)/to see each other often
常俸	常俸	cháng fèng	fixed salary of an official
常務	常务	cháng wù	routine/everyday business/daily operation (of a company)
常務委員會	常务委员会	cháng wù wěi yuán huì	standing committee (e.g. of National People's Congress)
常務理事	常务理事	cháng wù lǐ shì	permanent member of council
常勝軍	常胜军	cháng shèng jūn	Ever Victorious Army (1860-1864), Qing dynasty army equipped and trained jointly with Europeans and used esp. against the Taiping rebels
常問問題	常问问题	cháng wèn wèn tí	frequently asked questions/FAQ
常在河邊走，哪有不濕鞋	常在河边走，哪有不湿鞋	cháng zài hé biān zǒu , nǎ yǒu bù shī xié	a person who regularly walks by the river cannot avoid getting their shoes wet (proverb)/(fig.) it comes with the territory (e.g. a person with the power to grant favors will inevitably succumb to temptation and take a bribe)
常委	常委	cháng wěi	member of standing committee
常委會	常委会	cháng wěi huì	standing committee
常客	常客	cháng kè	frequent visitor/fig. sth that crops up frequently
常寧	常宁	Cháng níng	Changning county level city in Hengyang 衡陽|衡阳[Héng yáng], Hunan
常寧市	常宁市	Cháng níng shì	Changning county level city in Hengyang 衡陽|衡阳[Héng yáng], Hunan
常山	常山	Cháng shān	Changshan county in Quzhou 衢州[Qú zhōu], Zhejiang
常山縣	常山县	Cháng shān xiàn	Changshan county in Quzhou 衢州[Qú zhōu], Zhejiang
常州	常州	Cháng zhōu	Changzhou prefecture-level city in Jiangsu
常州市	常州市	Cháng zhōu shì	Changzhou prefecture-level city in Jiangsu
常常	常常	cháng cháng	frequently/often
常年	常年	cháng nián	all year round/for years on end/average year
常年累月	常年累月	cháng nián lěi yuè	variant of 長年累月|长年累月[cháng nián lěi yuè]
常微分方程	常微分方程	cháng wēi fēn fāng chéng	ordinary differential equation (ODE)
常德	常德	Cháng dé	Changde prefecture-level city in Hunan
常德地區	常德地区	Cháng dé dì qū	Changde prefecture in Hunan
常德市	常德市	Cháng dé shì	Changde prefecture-level city in Hunan
常德絲弦	常德丝弦	Cháng dé sī xián	Changde sixian, theatrical folk music style with singing in Changde dialect accompanied by traditional string instruments
常情	常情	cháng qíng	common sense/the way people usually feel about things
常態	常态	cháng tài	normal state
常態分佈	常态分布	cháng tài fēn bù	normal distribution (in statistics)
常態分布	常态分布	cháng tài fēn bù	normal distribution (in statistics)
常態分班	常态分班	cháng tài fēn bān	(Tw) grouping of students into classes of mixed ability
常態化	常态化	cháng tài huà	normalized (statistics)/to normalize (relations etc)/to become the norm
常態編班	常态编班	cháng tài biān bān	see 常態分班|常态分班[cháng tài fēn bān]
常數	常数	cháng shù	a constant (math.)
常春藤	常春藤	cháng chūn téng	ivy
常春藤學府	常春藤学府	cháng chūn téng xué fǔ	Ivy League school
常時	常时	cháng shí	frequently/often/usually/regularly
常染色體	常染色体	cháng rǎn sè tǐ	autosomal chromosome/autosome/autosomal
常模	常模	cháng mó	norm (typically observed pattern)
常法	常法	cháng fǎ	convention/normal practice/conventional treatment
常溫	常温	cháng wēn	room temperature/ordinary temperatures
常熟	常熟	Cháng shú	Changshu county level city in Suzhou 蘇州|苏州[Sū zhōu], Jiangsu
常熟市	常熟市	Cháng shú Shì	Changshu county level city in Suzhou 蘇州|苏州[Sū zhōu], Jiangsu
常犯	常犯	cháng fàn	to commit (an error) often/common (mistake)
常理	常理	cháng lǐ	common sense/conventional reasoning and morals
常用	常用	cháng yòng	in common usage
常用品	常用品	cháng yòng pǐn	everyday implement/object of everyday use
常用字	常用字	cháng yòng zì	everyday words
常綠	常绿	cháng lǜ	evergreen
常綠植物	常绿植物	cháng lǜ zhí wù	evergreen plant
常綠樹	常绿树	cháng lǜ shù	evergreen tree
常衡制	常衡制	Cháng héng zhì	Avoirdupois Weight, a system of weights based on the 16-ounce pound (or 7,000 grains)
常見	常见	cháng jiàn	commonly seen/common/to see sth frequently
常見問題	常见问题	cháng jiàn wèn tí	common problems/FAQ
常規	常规	cháng guī	code of conduct/conventions/common practice/routine (medical procedure etc)
常規武器	常规武器	cháng guī wǔ qì	conventional weapon
常言	常言	cháng yán	common saying
常言說得好	常言说得好	cháng yán shuō de hǎo	as the saying goes/as they say...
常設	常设	cháng shè	(of an organization etc) standing or permanent
常識	常识	cháng shí	common sense/general knowledge/CL:門|门[mén]
常軌	常轨	cháng guǐ	normal practice
常道	常道	cháng dào	normal and proper practice/conventional practice/common occurrence
常量	常量	cháng liàng	a constant (physics, math.)
常青	常青	cháng qīng	evergreen
常青藤	常青藤	cháng qīng téng	ivy
常青藤八校	常青藤八校	Cháng qīng téng Bā xiào	Ivy League
常項	常项	cháng xiàng	constant term (in a math expression)
常駐	常驻	cháng zhù	resident/permanent (representative)
平常	平常	píng cháng	ordinary/common/usually/ordinarily
平常心	平常心	píng cháng xīn	levelheadedness/calmness/equanimity
平常日	平常日	píng cháng rì	weekday
平平常常	平平常常	píng píng cháng cháng	nothing out of the ordinary/unglamorous
往常	往常	wǎng cháng	usual/customary
心律失常	心律失常	xīn lǜ shī cháng	arrhythmia
恆常	恒常	héng cháng	constant/constantly
恢復常態	恢复常态	huī fù cháng tài	to return to normal
慣常	惯常	guàn cháng	usual/customary
戲劇化人格違常	戏剧化人格违常	xì jù huà rén gé wéi cháng	histrionic personality disorder (HPD)
扯家常	扯家常	chě jiā cháng	to engage in small talk/to chit chat
拉家常	拉家常	lā jiā cháng	to talk or chat about ordinary daily life
日常	日常	rì cháng	daily/everyday
日常工作	日常工作	rì cháng gōng zuò	routine
時常	时常	shí cháng	often/frequently
普朗克常數	普朗克常数	Pǔ lǎng kè cháng shù	Planck's constant h, approximately equal to 6.626 x 10^-34 joule.seconds or 4.135 x 10^-15 electron volt.seconds
正常	正常	zhèng cháng	regular/normal/ordinary
正常化	正常化	zhèng cháng huà	normalization (of diplomatic relations etc)
正常工作	正常工作	zhèng cháng gōng zuò	normal operation/proper functioning
正常成本	正常成本	zhèng cháng chéng běn	normal cost (accountancy)
正常菌群	正常菌群	zhèng cháng jūn qún	microbiome/microbiota
每常	每常	měi cháng	frequently (in the past)/regularly
法輪常轉	法轮常转	Fǎ lún cháng zhuàn	the Wheel turns constantly (idiom); Buddhist teaching will overcome everything
無常	无常	wú cháng	variable/changeable/fickle/impermanence (Sanskrit: anitya)/ghost taking away the soul after death/to pass away/to die
照常	照常	zhào cháng	as usual
異乎尋常	异乎寻常	yì hū xún cháng	unusual/extraordinary
異常	异常	yì cháng	exceptional/abnormal/an anomaly
知足常樂	知足常乐	zhī zú cháng lè	satisfied with what one has (idiom)
磁異常	磁异常	cí yì cháng	magnetic anomaly (geology)
神經失常	神经失常	shén jīng shī cháng	mental aberration/nervous abnormality
禍福無常	祸福无常	huò fú wú cháng	disaster and happiness do not follow rules (idiom); future blessings and misfortunes are unpredictable
積分常數	积分常数	jī fēn cháng shù	constant of integration (math.)
素常	素常	sù cháng	ordinarily/usually
經常	经常	jīng cháng	frequently/constantly/regularly/often/day-to-day/everyday/daily
習以為常	习以为常	xí yǐ wéi cháng	accustomed to/used to
老生常談	老生常谈	lǎo shēng cháng tán	an old observation (idiom)/a truism/banal comments
言語失常症	言语失常症	yán yǔ shī cháng zhèng	speech defect
超乎尋常	超乎寻常	chāo hū xún cháng	out of the ordinary/exceptional
蹈常襲故	蹈常袭故	dǎo cháng xí gù	follow the same old path (idiom); stuck in a rut/always the same routine
通常	通常	tōng cháng	regular/usual/normal/usually/normally
進退有常	进退有常	jìn tuì yǒu cháng	to advance or retreat, each has its rules (idiom from Zhuangzi); many translations are possible
重力異常	重力异常	zhòng lì yì cháng	gravitational anomaly (geology)
閑話家常	闲话家常	xián huà jiā cháng	to chat about domestic trivia (idiom)
阿伏伽德羅常數	阿伏伽德罗常数	Ā fú jiā dé luó cháng shù	Avogadro's number (chemistry)
非常	非常	fēi cháng	very/very much/unusual/extraordinary
非常多	非常多	fēi cháng duō	much/very many
非常感謝	非常感谢	fēi cháng gǎn xiè	extremely grateful/very thankful
非常手段	非常手段	fēi cháng shǒu duàn	an emergency measure
非正常	非正常	fēi zhèng cháng	abnormal/irregular
類精神分裂型人格違常	类精神分裂型人格违常	lèi jīng shén fēn liè xíng rén gé wéi cháng	schizoid personality disorder (SPD)
黑白無常	黑白无常	Hēi Bái Wú cháng	Two deities, one short, one tall, chained together at the ankle, responsible for rewarding the good and punishing the bad
