戀	恋	liàn	to feel attached to/to long for/to love
依戀	依恋	yī liàn	to be fondly attached to/to not wish to part with/to cling to
初戀	初恋	chū liàn	first love
初戀感覺	初恋感觉	chū liàn gǎn jué	feelings of first love
同性戀	同性恋	tóng xìng liàn	homosexuality/gay person/gay love
同性戀恐懼症	同性恋恐惧症	tóng xìng liàn kǒng jù zhèng	homophobia
同性戀者	同性恋者	tóng xìng liàn zhě	homosexual/gay person
單戀	单恋	dān liàn	unrequited love/one-sided love
失戀	失恋	shī liàn	to lose one's love/to break up (in a romantic relationship)/to feel jilted
姐弟戀	姐弟恋	jiě dì liàn	love between an older woman and a younger man
婚外戀	婚外恋	hūn wài liàn	see 婚外情[hūn wài qíng]
婚戀	婚恋	hūn liàn	love and marriage
孌童戀	娈童恋	luán tóng liàn	pederasty
思戀	思恋	sī liàn	to miss/to long for
性物戀	性物恋	xìng wù liàn	(sexual) fetishism
愛戀	爱恋	ài liàn	in love with/to feel deeply attached to
三角戀愛	三角恋爱	sān jiǎo liàn ài	love triangle
戀人	恋人	liàn rén	lover/sweetheart
戀家	恋家	liàn jiā	home-loving/to feel a strong attachment to home life/to begrudge being away from home
戀屍癖	恋尸癖	liàn shī pǐ	necrophilia
戀念	恋念	liàn niàn	to have a sentimental attachment to (a place)/to miss (one's ancestral home etc)/to be nostalgic about
戀情	恋情	liàn qíng	romantic love
戀愛	恋爱	liàn ài	(romantic) love/CL:個|个[gè],場|场[chǎng]/in love/to have an affair
戀慕	恋慕	liàn mù	to be enamored of/to have tender feelings for/to be sentimentally attached to (a person or place)
戀戀	恋恋	liàn liàn	reluctant (to leave, to let go etc)
戀戀不捨	恋恋不舍	liàn liàn bù shě	reluctant to part
戀戰	恋战	liàn zhàn	to zealously continue fighting
戀棧	恋栈	liàn zhàn	to be reluctant to give up a post
戀歌	恋歌	liàn gē	love song
戀母情結	恋母情结	liàn mǔ qíng jié	Oedipus complex
戀父情結	恋父情结	liàn fù qíng jié	Electra complex
戀物	恋物	liàn wù	(sexual) fetishism
戀物狂	恋物狂	liàn wù kuáng	(sexual) fetishism
戀物癖	恋物癖	liàn wù pǐ	(sexual) fetishism
戀童犯	恋童犯	liàn tóng fàn	pedophile
戀童癖	恋童癖	liàn tóng pǐ	pedophilia/pedophile
戀腳癖	恋脚癖	liàn jiǎo pǐ	foot fetish
戀腳癖者	恋脚癖者	liàn jiǎo pǐ zhě	foot fetishist
戀舊	恋旧	liàn jiù	see 懷舊|怀旧[huái jiù]
戀舊情結	恋旧情结	liàn jiù qíng jié	dwelling on the past/difficulty in adapting to changes
早戀	早恋	zǎo liàn	puppy love
暗戀	暗恋	àn liàn	to be secretly in love with
棧戀	栈恋	zhàn liàn	sentimental attachment to a person or place
熱戀	热恋	rè liàn	to fall head over heels in love/to be passionately in love
生無可戀	生无可恋	shēng wú kě liàn	(Internet slang) nothing left to live for
留戀	留恋	liú liàn	reluctant to leave/to hate to have to go/to recall fondly
異地戀	异地恋	yì dì liàn	long-distance romance/long-distance relationship
異性戀	异性恋	yì xìng liàn	heterosexuality/heterosexual love
異性戀主義	异性恋主义	yì xìng liàn zhǔ yì	heterosexism
相戀	相恋	xiāng liàn	to love each other
眷戀	眷恋	juàn liàn	to miss/to long for/to remember with longing/yearning
移情別戀	移情别恋	yí qíng bié liàn	change of affection, shift of love (idiom); to change one's feelings to another love/to fall in love with sb else
網戀	网恋	wǎng liàn	online love affair/cyberdate/Internet dating
老馬戀棧	老马恋栈	lǎo mǎ liàn zhàn	lit. the old horse loves his stable/fig. sb old but reluctant to relinquish their post (idiom)
自戀	自恋	zì liàn	narcissism
虐戀	虐恋	nüè liàn	sadomasochism
談戀愛	谈恋爱	tán liàn ài	to court/to go steady/to be dating
貪戀	贪恋	tān liàn	to cling to/to be reluctant to give up (sth)/to have a fondness for (an indulgence etc)
迷戀	迷恋	mí liàn	to be infatuated with/to be enchanted by/to be passionate about
雙性戀	双性恋	shuāng xìng liàn	bisexual/bisexuality
駑馬戀棧	驽马恋栈	nú mǎ liàn zhàn	an incompetent man clings to a good position (idiom)
駑馬戀棧豆	驽马恋栈豆	nú mǎ liàn zhàn dòu	see 駑馬戀棧|驽马恋栈[nú mǎ liàn zhàn]
黃昏戀	黄昏恋	huáng hūn liàn	fig. romantic relationship between an elderly couple/falling in love in the autumn of one's life
