恐	恐	kǒng	afraid/frightened/to fear
似鳥恐龍	似鸟恐龙	sì niǎo kǒng lóng	ornithischian/bird-like dinosaur
反恐	反恐	fǎn kǒng	anti-terrorism/to fight against terrorism
反恐戰爭	反恐战争	fǎn kǒng zhàn zhēng	war on terrorism
同性戀恐懼症	同性恋恐惧症	tóng xìng liàn kǒng jù zhèng	homophobia
唯恐	唯恐	wéi kǒng	for fear that/lest/also written 惟恐
唯恐天下不亂	唯恐天下不乱	wéi kǒng tiān xià bù luàn	to wish for the whole world to be in chaos (idiom)
單方恐嚇	单方恐吓	dān fāng kǒng hè	unilateral threat
基地恐怖組織	基地恐怖组织	Jī dì Kǒng bù Zǔ zhī	Al-Qaeda/same as 基地組織|基地组织
幽閉恐懼	幽闭恐惧	yōu bì kǒng jù	claustrophobia
幽閉恐懼症	幽闭恐惧症	yōu bì kǒng jù zhèng	claustrophobia
廣場恐怖症	广场恐怖症	guǎng chǎng kǒng bù zhèng	agoraphobia
廣場恐懼	广场恐惧	guǎng chǎng kǒng jù	agoraphobia
廣場恐懼症	广场恐惧症	guǎng chǎng kǒng jù zhèng	agoraphobia
三角恐龍	三角恐龙	sān jiǎo kǒng lóng	triceratops (dinosaur)
恐共	恐共	kǒng Gòng	to fear the Communists
恐同	恐同	kǒng tóng	see 恐同症[kǒng tóng zhèng]
恐同症	恐同症	kǒng tóng zhèng	homophobia
恐嚇	恐吓	kǒng hè	to threaten/to menace
恐怕	恐怕	kǒng pà	fear/to dread/I'm afraid that.../perhaps/maybe
恐怖	恐怖	kǒng bù	terrible/frightful/frightening/terror/terrorist
恐怖主義	恐怖主义	kǒng bù zhǔ yì	terrorism
恐怖主義者	恐怖主义者	kǒng bù zhǔ yì zhě	terrorist
恐怖分子	恐怖分子	kǒng bù fèn zǐ	terrorist
恐怖片	恐怖片	kǒng bù piàn	horror movie/CL:部[bù]
恐怖片兒	恐怖片儿	kǒng bù piān r5	erhua variant of 恐怖片[kǒng bù piàn]
恐怖症	恐怖症	kǒng bù zhèng	phobia
恐怖組織	恐怖组织	kǒng bù zǔ zhī	terrorist organization
恐怖襲擊	恐怖袭击	kǒng bù xí jī	terrorist attack
恐怖電影	恐怖电影	kǒng bù diàn yǐng	horror movie
恐慌	恐慌	kǒng huāng	panic/panicky/panic-stricken
恐慌發作	恐慌发作	kǒng huāng fā zuò	panic attack
恐懼	恐惧	kǒng jù	to be frightened/fear/dread
恐懼症	恐惧症	kǒng jù zhèng	phobia
恐曠症	恐旷症	kǒng kuàng zhèng	agoraphobia
恐水病	恐水病	kǒng shuǐ bìng	rabies
恐水症	恐水症	kǒng shuǐ zhèng	rabies/hydrophobia
恐法症	恐法症	kǒng Fǎ zhèng	Francophobia
恐狼	恐狼	kǒng láng	dire wolf (Canis dirus)
恐血症	恐血症	kǒng xuè zhèng	blood phobia/hemophobia
恐襲	恐袭	kǒng xí	terrorist attack (abbr. for 恐怖襲擊|恐怖袭击[kǒng bù xí jī])
恐韓症	恐韩症	kǒng Hán zhèng	Koreaphobia
恐高症	恐高症	kǒng gāo zhèng	acrophobia/fear of heights
恐鳥	恐鸟	kǒng niǎo	monstrous bird/moa (genus Dinornithidae, extinct bird of New Zealand)
恐龍	恐龙	kǒng lóng	dinosaur/CL:頭|头[tóu]/(slang) ugly person
恐龍妹	恐龙妹	kǒng lóng mèi	ugly girl (slang)
恐龍總目	恐龙总目	kǒng lóng zǒng mù	Dinosauria, superorder within class Sauropsida containing dinosaurs and birds
恐龍類	恐龙类	kǒng lóng lèi	dinosaurs
惟恐	惟恐	wéi kǒng	for fear that/lest/also written 唯恐
惶恐	惶恐	huáng kǒng	terrified
惶恐不安	惶恐不安	huáng kǒng bù ān	anxious/panicky
支恐	支恐	zhī kǒng	to support terrorism/abbr. for 支持恐怖主義|支持恐怖主义[zhī chí kǒng bù zhǔ yì]
暴恐	暴恐	bào kǒng	(attributive) terrorist
有恃無恐	有恃无恐	yǒu shì wú kǒng	secure in the knowledge that one has backing
爭先恐後	争先恐后	zhēng xiān kǒng hòu	striving to be first and fearing to be last (idiom); outdoing one another
獸腳類恐龍	兽脚类恐龙	shòu jiǎo lèi kǒng lóng	theropod (beast-footed dinosaur group)/suborder Theropoda within order Saurischia containing carnivorous dinosaurs
生物恐怖主義	生物恐怖主义	shēng wù kǒng bù zhǔ yì	bioterrorism
白色恐怖	白色恐怖	Bái sè kǒng bù	White Terror
社交恐懼症	社交恐惧症	shè jiāo kǒng jù zhèng	social phobia/social anxiety
血液恐怖症	血液恐怖症	xuè yè kǒng bù zhèng	blood phobia
誠惶誠恐	诚惶诚恐	chéng huáng chéng kǒng	in fear and trepidation (idiom); in reverence before your majesty (court formula of humility)
驚恐	惊恐	jīng kǒng	to be alarmed/to be frightened
驚恐翼龍	惊恐翼龙	Jīng kǒng yì lóng	Phobetor (genus of pterodactyloid pterosaur)
驚恐萬狀	惊恐万状	jīng kǒng wàn zhuàng	convulsed with fear (idiom)
